UF;Municipio;Automóvel;Caminhão;Caminhonete;Motocicleta;Ônibus;Utilitário;Outros;Total
AC;ACRELANDIA;1313;335;640;3158;42;10;568;6066
AC;ASSIS BRASIL;314;24;139;1106;3;2;157;1745
AC;BRASILEIA;2260;274;1133;4380;19;32;1489;9587
AC;BUJARI;607;122;264;923;12;3;159;2090
AC;CAPIXABA;599;86;221;1032;16;1;185;2140
AC;CRUZEIRO DO SUL;6729;733;2788;15401;80;107;7242;33080
AC;EPITACIOLANDIA;1719;253;815;2407;16;16;1150;6376
AC;FEIJO;558;116;338;2039;12;12;704;3779
AC;JORDAO;12;5;13;64;0;0;29;123
AC;MANCIO LIMA;604;95;309;2077;16;7;557;3665
AC;MANOEL URBANO;222;50;145;560;6;2;141;1126
AC;MARECHAL THAUMATURGO;8;13;34;258;9;0;34;356
AC;PLACIDO DE CASTRO;1288;155;512;2202;27;5;530;4719
AC;PORTO ACRE;788;172;403;2026;47;3;239;3678
AC;PORTO WALTER;4;9;28;214;5;1;47;308
AC;RIO BRANCO;69430;4262;17713;72342;832;1127;21946;187652
AC;RODRIGUES ALVES;177;17;106;951;9;2;272;1534
AC;SANTA ROSA DO PURUS;16;5;24;118;3;0;19;185
AC;SENA MADUREIRA;1467;115;874;4352;10;14;1667;8499
AC;SENADOR GUIOMARD;2100;351;753;2808;35;15;771;6833
AC;TARAUACA;586;156;387;2389;23;17;1342;4900
AC;XAPURI;814;76;392;2533;6;10;387;4218
AL;AGUA BRANCA;1050;120;548;2317;31;4;320;4390
AL;ANADIA;1070;46;155;1157;48;9;377;2862
AL;ARAPIRACA;34473;3020;7113;44111;503;594;21928;111742
AL;ATALAIA;3672;209;276;1593;162;15;879;6806
AL;BARRA DE SANTO ANTONIO;928;31;110;774;26;8;313;2190
AL;BARRA DE SAO MIGUEL;838;26;124;574;13;15;333;1923
AL;BATALHA;1181;138;234;1822;21;12;426;3834
AL;BELEM;337;9;72;652;8;0;105;1183
AL;BELO MONTE;188;36;61;444;7;1;46;783
AL;BOCA DA MATA;1947;207;272;2220;102;7;924;5679
AL;BRANQUINHA;432;32;83;787;21;1;105;1461
AL;CACIMBINHAS;598;83;132;1119;13;7;179;2131
AL;CAJUEIRO;1079;90;123;1307;51;6;344;3000
AL;CAMPESTRE;279;38;50;149;8;2;127;653
AL;CAMPO ALEGRE;1954;134;288;1664;158;7;902;5107
AL;CAMPO GRANDE;551;47;132;1584;23;4;141;2482
AL;CANAPI;699;70;230;1436;27;1;222;2685
AL;CAPELA;824;69;102;805;66;5;223;2094
AL;CARNEIROS;331;32;90;675;10;3;86;1227
AL;CHA PRETA;314;30;106;760;6;3;58;1277
AL;COITE DO NOIA;635;84;144;1664;25;0;209;2761
AL;COLONIA LEOPOLDINA;737;103;141;551;35;2;162;1731
AL;COQUEIRO SECO;472;10;51;446;9;1;80;1069
AL;CORURIPE;4109;376;991;5333;235;48;2431;13523
AL;CRAIBAS;1677;233;409;2741;37;8;691;5796
AL;DELMIRO GOUVEIA;7646;789;1730;7910;119;61;2736;20991
AL;DOIS RIACHOS;651;85;161;1594;13;3;216;2723
AL;ESTRELA DE ALAGOAS;1006;59;248;1827;26;7;285;3458
AL;FEIRA GRANDE;998;111;394;2682;50;4;625;4864
AL;FELIZ DESERTO;228;14;49;262;9;1;71;634
AL;FLEXEIRAS;649;35;93;532;49;3;123;1484
AL;GIRAU DO PONCIANO;2462;220;524;4584;94;12;845;8741
AL;IBATEGUARA;707;49;172;1029;21;9;229;2216
AL;IGACI;1654;143;384;2721;41;5;601;5549
AL;IGREJA NOVA;926;79;156;2847;110;4;422;4544
AL;INHAPI;963;82;352;2456;10;3;369;4235
AL;JACARE DOS HOMENS;307;40;58;479;17;1;58;960
AL;JACUIPE;213;14;42;258;20;0;64;611
AL;JAPARATINGA;602;24;90;513;13;7;134;1383
AL;JARAMATAIA;320;29;74;359;7;2;65;856
AL;JEQUIA DA PRAIA;445;40;105;586;48;5;112;1341
AL;JOAQUIM GOMES;934;116;205;987;86;4;189;2521
AL;JUNDIA;242;16;42;255;13;0;52;620
AL;JUNQUEIRO;1520;187;390;2390;116;5;1080;5688
AL;LAGOA DA CANOA;1369;100;292;2595;42;11;550;4959
AL;LIMOEIRO DE ANADIA;1291;157;447;2433;68;5;797;5198
AL;MACEIO;197489;7648;23831;77166;2287;5155;38381;351957
AL;MAJOR ISIDORO;1006;109;212;1787;31;12;313;3470
AL;MAR VERMELHO;242;14;47;587;9;0;54;953
AL;MARAGOGI;1852;93;324;1153;49;30;687;4188
AL;MARAVILHA;612;68;141;1168;11;0;150;2150
AL;MARECHAL DEODORO;5731;300;725;2688;190;141;2004;11779
AL;MARIBONDO;1065;72;217;1096;19;5;327;2801
AL;MATA GRANDE;937;71;528;2377;20;6;257;4196
AL;MATRIZ DE CAMARAGIBE;1522;143;268;1392;139;12;454;3930
AL;MESSIAS;1000;70;131;888;93;5;270;2457
AL;MINADOR DO NEGRAO;382;58;98;721;9;2;53;1323
AL;MONTEIROPOLIS;295;24;100;637;6;0;60;1122
AL;MURICI;1322;144;219;1982;103;9;566;4345
AL;NOVO LINO;827;85;90;455;67;2;190;1716
AL;OLHO D'AGUA DAS FLORES;1688;145;437;2581;35;12;570;5468
AL;OLHO D'AGUA DO CASADO;527;36;117;830;12;0;90;1612
AL;OLHO D'AGUA GRANDE;249;16;47;622;14;0;69;1017
AL;OLIVENCA;702;64;142;1442;14;10;145;2519
AL;OURO BRANCO;813;107;178;1375;33;3;226;2735
AL;PALESTINA;192;11;46;224;4;0;53;530
AL;PALMEIRA DOS INDIOS;8655;658;1689;10958;92;82;3144;25278
AL;PAO DE ACUCAR;937;72;200;1519;17;7;395;3147
AL;PARICONHA;476;54;223;1310;13;3;130;2209
AL;PARIPUEIRA;936;64;158;587;18;24;343;2130
AL;PASSO DE CAMARAGIBE;731;39;89;613;31;6;251;1760
AL;PAULO JACINTO;336;15;106;797;9;2;71;1336
AL;PENEDO;6082;293;1044;7127;299;65;2851;17761
AL;PIACABUCU;751;35;238;777;20;7;375;2203
AL;PILAR;3383;157;384;1958;91;26;1236;7235
AL;PINDOBA;94;9;34;254;4;0;18;413
AL;PIRANHAS;1608;90;367;2867;20;13;441;5406
AL;POCO DAS TRINCHEIRAS;656;78;165;1536;25;5;196;2661
AL;PORTO CALVO;1792;209;250;2142;77;13;667;5150
AL;PORTO DE PEDRAS;503;23;73;536;10;2;163;1310
AL;PORTO REAL DO COLEGIO;710;37;115;1144;28;3;206;2243
AL;QUEBRANGULO;538;36;157;1238;17;2;126;2114
AL;RIO LARGO;8308;466;892;4652;220;58;2099;16695
AL;ROTEIRO;408;15;58;337;11;4;136;969
AL;SANTA LUZIA DO NORTE;596;23;66;357;47;2;115;1206
AL;SANTANA DO IPANEMA;4434;472;1015;8676;61;47;1676;16381
AL;SANTANA DO MUNDAU;505;74;151;1611;16;4;241;2602
AL;SAO BRAS;171;8;42;268;8;1;39;537
AL;SAO JOSE DA LAJE;1393;139;205;1671;74;26;495;4003
AL;SAO JOSE DA TAPERA;1824;151;367;2526;46;8;517;5439
AL;SAO LUIS DO QUITUNDE;1907;242;268;1713;241;9;573;4953
AL;SAO MIGUEL DOS CAMPOS;5650;407;705;5656;221;55;2740;15434
AL;SAO MIGUEL DOS MILAGRES;633;29;127;564;7;8;248;1616
AL;SAO SEBASTIAO;2008;177;454;3891;202;9;1325;8066
AL;SATUBA;2002;80;178;1006;26;8;392;3692
AL;SENADOR RUI PALMEIRA;527;45;173;1199;15;0;136;2095
AL;TANQUE D'ARCA;371;17;63;719;9;0;112;1291
AL;TAQUARANA;1119;122;300;2640;47;6;441;4675
AL;TEOTONIO VILELA;2545;193;398;3556;228;24;1577;8521
AL;TRAIPU;763;104;174;2218;28;3;185;3475
AL;UNIAO DOS PALMARES;5026;539;1011;8860;254;36;1932;17658
AL;VICOSA;1830;139;353;3172;54;21;434;6003
AM;ALVARAES;17;11;31;453;3;0;191;706
AM;AMATURA;5;6;13;185;1;0;102;312
AM;ANAMA;9;1;8;126;6;0;36;186
AM;ANORI;20;15;40;306;3;0;115;499
AM;APUI;369;187;548;2057;37;12;646;3856
AM;ATALAIA DO NORTE;18;3;32;270;1;0;168;492
AM;AUTAZES;239;48;135;1142;24;3;470;2061
AM;BARCELOS;114;14;74;608;0;1;287;1098
AM;BARREIRINHA;8;9;25;401;6;1;179;629
AM;BENJAMIN CONSTANT;63;21;45;880;5;2;663;1679
AM;BERURI;26;9;39;264;0;0;83;421
AM;BOA VISTA DO RAMOS;8;3;15;330;1;0;80;437
AM;BOCA DO ACRE;539;71;184;1891;8;1;633;3327
AM;BORBA;63;23;53;537;6;1;221;904
AM;CAAPIRANGA;22;12;37;134;8;0;70;283
AM;CANUTAMA;19;6;22;139;1;0;57;244
AM;CARAUARI;83;50;106;1766;1;1;706;2713
AM;CAREIRO;462;99;276;1103;91;4;396;2431
AM;CAREIRO DA VARZEA;128;31;52;119;47;0;109;486
AM;COARI;564;137;411;6584;17;12;2799;10524
AM;CODAJAS;30;9;46;439;4;2;115;645
AM;EIRUNEPE;95;41;96;1135;8;0;545;1920
AM;ENVIRA;12;17;36;308;5;0;85;463
AM;FONTE BOA;23;21;57;1181;0;0;281;1563
AM;GUAJARA;78;10;65;114;10;3;34;314
AM;HUMAITA;1231;323;635;3687;44;23;2360;8303
AM;IPIXUNA;7;4;11;8;3;0;2;35
AM;IRANDUBA;1828;351;778;2938;147;13;1010;7065
AM;ITACOATIARA;3258;393;1009;11094;172;13;8417;24356
AM;ITAMARATI;5;12;15;219;0;0;43;294
AM;ITAPIRANGA;170;28;113;376;8;1;140;836
AM;JAPURA;7;6;17;245;4;0;60;339
AM;JURUA;6;10;23;340;4;0;115;498
AM;JUTAI;9;6;39;479;0;0;96;629
AM;LABREA;155;50;175;1334;9;8;569;2300
AM;MANACAPURU;2881;385;1205;8614;125;25;4089;17324
AM;MANAQUIRI;115;14;75;410;9;0;100;723
AM;MANAUS;390495;16721;80352;182443;8108;5407;69618;753144
AM;MANICORE;134;50;137;1126;19;7;764;2237
AM;MARAA;8;6;18;370;0;0;149;551
AM;MAUES;418;59;216;2759;26;5;1668;5151
AM;NHAMUNDA;7;9;11;326;8;0;202;563
AM;NOVA OLINDA DO NORTE;63;26;76;630;9;0;374;1178
AM;NOVO AIRAO;315;32;128;689;12;3;205;1384
AM;NOVO ARIPUANA;27;26;47;579;8;1;190;878
AM;PARINTINS;1598;169;515;9519;29;16;7005;18851
AM;PAUINI;19;4;14;142;1;0;44;224
AM;PRESIDENTE FIGUEIREDO;1916;344;941;2620;85;20;1138;7064
AM;RIO PRETO DA EVA;918;188;614;2207;78;11;550;4566
AM;SANTA ISABEL DO RIO NEGRO;14;11;34;218;3;1;127;408
AM;SANTO ANTONIO DO ICA;9;14;36;623;1;0;193;876
AM;SAO GABRIEL DA CACHOEIRA;1411;110;467;1170;38;6;740;3942
AM;SAO PAULO DE OLIVENCA;12;10;26;890;6;0;254;1198
AM;SAO SEBASTIAO DO UATUMA;16;6;13;206;1;0;50;292
AM;SILVES;46;12;33;219;4;0;73;387
AM;TABATINGA;967;85;257;4746;7;11;3445;9518
AM;TAPAUA;28;6;38;333;2;0;162;569
AM;TEFE;971;79;388;7001;22;9;3635;12105
AM;TONANTINS;4;6;12;354;1;0;123;500
AM;UARINI;4;11;20;437;2;0;83;557
AM;URUCARA;31;23;51;459;2;0;216;782
AM;URUCURITUBA;23;9;28;394;2;0;147;603
AP;AMAPA;237;11;44;287;2;1;75;657
AP;CALCOENE;190;16;51;447;4;0;65;773
AP;CUTIAS;52;4;13;82;0;0;19;170
AP;FERREIRA GOMES;243;12;54;193;5;2;66;575
AP;ITAUBAL;38;9;11;89;5;0;9;161
AP;LARANJAL DO JARI;1435;106;347;2639;23;27;827;5404
AP;MACAPA;69501;3128;18970;50091;894;944;16908;160436
AP;MAZAGAO;437;43;74;383;22;1;122;1082
AP;OIAPOQUE;1049;75;260;1599;22;23;501;3529
AP;PEDRA BRANCA DO AMAPARI;258;32;63;236;27;1;106;723
AP;PORTO GRANDE;789;71;158;999;24;5;286;2332
AP;PRACUUBA;48;6;13;55;2;0;8;132
AP;SANTANA;10751;660;2669;9765;199;59;3907;28010
AP;SERRA DO NAVIO;245;16;41;134;5;1;62;504
AP;TARTARUGALZINHO;143;24;44;288;7;0;74;580
AP;VITORIA DO JARI;113;14;35;175;4;1;49;391
BA;ABAIRA;938;64;280;685;18;10;126;2121
BA;ABARE;634;52;239;1510;25;4;132;2596
BA;ACAJUTIBA;875;79;185;1224;23;3;368;2757
BA;ADUSTINA;270;17;79;1131;11;1;160;1669
BA;AGUA FRIA;804;42;107;1102;48;6;146;2255
BA;AIQUARA;185;8;51;259;6;1;38;548
BA;ALAGOINHAS;25118;1513;4038;16396;684;557;10047;58353
BA;ALCOBACA;1407;65;388;1655;37;15;557;4124
BA;ALMADINA;357;17;63;212;6;0;49;704
BA;AMARGOSA;4915;353;1050;4000;102;53;1392;11865
BA;AMELIA RODRIGUES;2652;294;330;1767;46;13;1325;6427
BA;AMERICA DOURADA;1041;47;167;937;17;3;104;2316
BA;ANAGE;1261;151;281;1047;54;4;266;3064
BA;ANDARAI;578;53;168;728;28;7;95;1657
BA;ANDORINHA;1225;96;377;1365;57;6;147;3273
BA;ANGICAL;746;52;269;1011;41;4;177;2300
BA;ANGUERA;631;24;67;609;15;4;119;1469
BA;ANTAS;609;36;149;1156;13;9;257;2229
BA;ANTONIO CARDOSO;537;13;44;785;23;2;97;1501
BA;ANTONIO GONCALVES;622;27;141;794;14;6;114;1718
BA;APORA;873;57;148;1521;46;2;333;2980
BA;APUAREMA;339;32;98;571;12;1;103;1156
BA;ARACAS;1016;96;171;681;38;6;239;2247
BA;ARACATU;1137;144;336;1051;38;4;208;2918
BA;ARACI;3726;316;846;3004;82;39;758;8771
BA;ARAMARI;593;42;98;570;20;7;112;1442
BA;ARATACA;405;38;117;475;5;1;58;1099
BA;ARATUIPE;464;47;92;718;20;1;104;1446
BA;AURELINO LEAL;645;53;128;523;16;2;173;1540
BA;BAIANOPOLIS;800;73;308;1020;46;6;237;2490
BA;BAIXA GRANDE;1328;123;377;1507;61;10;296;3702
BA;BANZAE;474;28;162;952;30;3;180;1829
BA;BARRA;1500;107;812;3486;47;43;1003;6998
BA;BARRA DA ESTIVA;2773;322;1311;2652;81;45;709;7893
BA;BARRA DO CHOCA;2233;164;591;1629;46;12;693;5368
BA;BARRA DO MENDES;969;80;369;541;31;19;179;2188
BA;BARRA DO ROCHA;286;15;65;281;9;2;52;710
BA;BARREIRAS;30563;2567;8994;25213;509;923;13832;82601
BA;BARRO ALTO;936;62;253;785;30;4;144;2214
BA;BARRO PRETO;311;20;57;194;13;1;37;633
BA;BARROCAS;1919;125;250;2031;33;3;536;4897
BA;BELMONTE;879;63;296;1073;42;10;350;2713
BA;BELO CAMPO;1391;152;353;665;49;11;174;2795
BA;BIRITINGA;1050;39;164;1198;39;5;113;2608
BA;BOA NOVA;644;43;153;341;28;4;184;1397
BA;BOA VISTA DO TUPIM;871;81;233;1173;27;1;205;2591
BA;BOM JESUS DA LAPA;5553;544;2066;12933;161;108;2101;23466
BA;BOM JESUS DA SERRA;470;47;143;337;25;0;120;1142
BA;BONINAL;1352;112;505;910;44;11;227;3161
BA;BONITO;1070;124;381;454;28;10;114;2181
BA;BOQUIRA;1393;151;532;2483;77;7;279;4922
BA;BOTUPORA;909;73;291;896;54;12;167;2402
BA;BREJOES;1128;109;259;749;43;4;157;2449
BA;BREJOLANDIA;415;37;177;1293;21;1;100;2044
BA;BROTAS DE MACAUBAS;792;40;327;552;27;4;171;1913
BA;BRUMADO;12570;1889;3748;15928;373;188;4783;39479
BA;BUERAREMA;1368;157;381;1312;56;10;230;3514
BA;BURITIRAMA;468;47;296;608;27;5;124;1575
BA;CAATIBA;365;20;96;445;3;1;66;996
BA;CABACEIRAS DO PARAGUACU;825;108;201;1246;73;7;201;2661
BA;CACHOEIRA;2614;135;397;1728;92;24;621;5611
BA;CACULE;3038;437;1277;2755;56;42;674;8279
BA;CAEM;636;34;169;840;22;2;87;1790
BA;CAETANOS;431;101;200;603;20;2;58;1415
BA;CAETITE;7659;652;2739;4693;177;91;1965;17976
BA;CAFARNAUM;1265;89;402;1326;55;14;160;3311
BA;CAIRU;270;23;168;299;13;21;101;895
BA;CALDEIRAO GRANDE;791;38;134;1048;22;0;113;2146
BA;CAMACAN;2242;200;695;2260;52;21;538;6008
BA;CAMACARI;47055;2552;6513;23294;1165;676;14829;96084
BA;CAMAMU;1899;200;583;2312;41;31;485;5551
BA;CAMPO ALEGRE DE LOURDES;269;60;203;1349;18;6;160;2065
BA;CAMPO FORMOSO;5887;366;2099;6862;131;51;1353;16749
BA;CANAPOLIS;318;25;231;1214;14;0;133;1935
BA;CANARANA;2270;210;586;2040;51;24;323;5504
BA;CANAVIEIRAS;1752;115;613;2383;21;37;524;5445
BA;CANDEAL;291;34;63;525;25;0;102;1040
BA;CANDEIAS;11709;882;1520;5407;412;110;6931;26971
BA;CANDIBA;1460;86;462;938;25;8;209;3188
BA;CANDIDO SALES;2357;335;742;1398;55;12;480;5379
BA;CANSANCAO;2910;227;696;2535;92;20;681;7161
BA;CANUDOS;939;68;288;1133;51;5;155;2639
BA;CAPELA DO ALTO ALEGRE;884;89;170;1293;30;3;193;2662
BA;CAPIM GROSSO;4633;703;1288;6177;127;58;1746;14732
BA;CARAIBAS;599;79;159;307;27;4;108;1283
BA;CARAVELAS;1200;47;271;1048;39;13;559;3177
BA;CARDEAL DA SILVA;551;33;98;462;26;6;78;1254
BA;CARINHANHA;1567;126;595;2890;55;19;302;5554
BA;CASA NOVA;3624;389;1728;7031;233;42;779;13826
BA;CASTRO ALVES;1935;179;430;2457;88;11;687;5787
BA;CATOLANDIA;185;11;59;201;12;0;43;511
BA;CATU;7159;443;1270;4453;141;61;3134;16661
BA;CATURAMA;692;55;195;830;21;4;90;1887
BA;CENTRAL;1465;110;290;1121;17;14;173;3190
BA;CHORROCHO;419;51;129;569;16;2;51;1237
BA;CICERO DANTAS;2445;145;640;4118;71;29;1098;8546
BA;CIPO;1421;55;191;2518;25;6;814;5030
BA;COARACI;1653;131;458;1251;36;13;336;3878
BA;COCOS;1270;113;632;2297;47;11;250;4620
BA;CONCEICAO DA FEIRA;1777;264;304;2175;21;17;544;5102
BA;CONCEICAO DO ALMEIDA;1319;139;320;1375;43;6;313;3515
BA;CONCEICAO DO COITE;9470;667;1843;8278;165;107;3454;23984
BA;CONCEICAO DO JACUIPE;3710;417;823;4313;37;40;2465;11805
BA;CONDE;1128;62;257;1625;29;13;424;3538
BA;CONDEUBA;1550;129;457;1215;81;8;384;3824
BA;CONTENDAS DO SINCORA;269;39;91;409;12;1;57;878
BA;CORACAO DE MARIA;1883;137;456;2583;76;18;751;5904
BA;CORDEIROS;659;43;200;555;23;12;132;1624
BA;CORIBE;849;55;453;1453;32;8;161;3011
BA;CORONEL JOAO SA;260;12;60;1236;26;2;76;1672
BA;CORRENTINA;1968;172;1010;4888;101;16;911;9066
BA;COTEGIPE;485;66;278;904;29;3;306;2071
BA;CRAVOLANDIA;267;26;69;290;11;0;30;693
BA;CRISOPOLIS;1033;76;204;2015;52;4;289;3673
BA;CRISTOPOLIS;951;74;457;885;39;5;283;2694
BA;CRUZ DAS ALMAS;11180;1208;2016;12668;119;151;3770;31112
BA;CURACA;946;110;470;2054;53;10;190;3833
BA;DARIO MEIRA;476;22;132;473;5;2;71;1181
BA;DIAS D'AVILA;11214;743;1396;4766;446;124;4444;23133
BA;DOM BASILIO;1074;375;452;2321;42;9;214;4487
BA;DOM MACEDO COSTA;384;15;70;456;10;3;118;1056
BA;ELISIO MEDRADO;765;45;125;776;19;4;132;1866
BA;ENCRUZILHADA;909;81;333;913;20;5;193;2454
BA;ENTRE RIOS;3483;288;726;3325;154;40;1201;9217
BA;ERICO CARDOSO;693;47;284;1013;30;5;112;2184
BA;ESPLANADA;2446;150;529;2532;117;19;984;6777
BA;EUCLIDES DA CUNHA;4950;339;1159;6041;292;104;1223;14108
BA;EUNAPOLIS;16781;1520;4317;17110;535;227;8622;49112
BA;FATIMA;553;22;132;1115;26;4;209;2061
BA;FEIRA DA MATA;368;21;114;569;14;1;54;1141
BA;FEIRA DE SANTANA;129807;9389;22192;79719;1467;2346;46641;291561
BA;FILADELFIA;1166;169;261;1790;35;5;190;3616
BA;FIRMINO ALVES;375;21;65;229;4;1;35;730
BA;FLORESTA AZUL;639;48;112;464;3;5;123;1394
BA;FORMOSA DO RIO PRETO;1233;171;631;1989;37;25;999;5085
BA;GANDU;3891;343;901;3812;39;40;1354;10380
BA;GAVIAO;331;27;79;384;10;0;66;897
BA;GENTIO DO OURO;487;31;367;617;11;1;91;1605
BA;GLORIA;1172;71;370;1770;52;6;182;3623
BA;GONGOGI;299;18;45;232;5;2;53;654
BA;GOVERNADOR MANGABEIRA;2678;289;392;2827;55;13;670;6924
BA;GUAJERU;538;35;125;406;18;2;89;1213
BA;GUANAMBI;16365;1416;5418;20272;254;283;4666;48674
BA;GUARATINGA;1030;92;341;1853;42;2;304;3664
BA;HELIOPOLIS;519;25;94;699;23;2;191;1553
BA;IACU;1924;173;449;2374;48;7;448;5423
BA;IBIASSUCE;1121;100;411;911;26;8;225;2802
BA;IBICARAI;2197;149;426;1476;38;29;519;4834
BA;IBICOARA;1705;296;827;2017;93;23;383;5344
BA;IBICUI;938;61;273;1154;19;8;210;2663
BA;IBIPEBA;1032;63;348;785;23;12;125;2388
BA;IBIPITANGA;1186;108;516;2151;50;8;406;4425
BA;IBIQUERA;205;10;38;207;6;1;28;495
BA;IBIRAPITANGA;1096;73;286;782;26;3;285;2551
BA;IBIRAPUA;631;111;187;710;15;9;233;1896
BA;IBIRATAIA;1340;97;343;1958;23;11;491;4263
BA;IBITIARA;1456;131;474;1460;62;4;245;3832
BA;IBITITA;1392;64;266;845;30;3;127;2727
BA;IBOTIRAMA;3245;310;1004;4175;43;41;1359;10177
BA;ICHU;647;45;114;892;19;0;144;1861
BA;IGAPORA;1351;120;580;859;50;7;216;3183
BA;IGRAPIUNA;468;54;145;905;27;6;117;1722
BA;IGUAI;1286;73;411;1527;59;9;250;3615
BA;ILHEUS;22270;899;4052;12117;321;417;4610;44686
BA;INHAMBUPE;2651;234;568;4027;122;24;1193;8819
BA;IPECAETA;695;32;97;748;55;2;108;1737
BA;IPIAU;5217;452;1261;6065;96;107;1692;14890
BA;IPIRA;4819;499;1574;9108;163;47;1265;17475
BA;IPUPIARA;679;92;471;1087;9;16;161;2515
BA;IRAJUBA;449;47;136;403;23;1;79;1138
BA;IRAMAIA;458;51;163;542;23;1;108;1346
BA;IRAQUARA;2183;160;606;1368;57;12;276;4662
BA;IRARA;2753;173;436;3056;90;5;641;7154
BA;IRECE;12848;1156;3466;12835;309;261;3456;34331
BA;ITABELA;2530;335;876;3523;136;40;1047;8487
BA;ITABERABA;7417;639;2047;9869;116;75;3783;23946
BA;ITABUNA;36058;2063;6641;22489;828;556;10671;79306
BA;ITACARE;1045;53;299;1064;12;51;323;2847
BA;ITAETE;762;85;309;1211;30;3;143;2543
BA;ITAGI;577;48;205;994;9;4;88;1925
BA;ITAGIBA;765;42;232;806;23;10;221;2099
BA;ITAGIMIRIM;561;56;168;437;10;4;162;1398
BA;ITAGUACU DA BAHIA;649;36;160;569;9;3;49;1475
BA;ITAJU DO COLONIA;285;27;76;441;7;0;45;881
BA;ITAJUIPE;1837;86;320;1293;24;9;484;4053
BA;ITAMARAJU;7011;511;2339;9408;182;70;2829;22350
BA;ITAMARI;429;50;106;765;2;1;114;1467
BA;ITAMBE;1388;85;322;1087;14;4;355;3255
BA;ITANAGRA;223;30;54;301;12;0;52;672
BA;ITANHEM;1637;74;637;2106;32;17;238;4741
BA;ITAPARICA;1623;57;129;911;37;9;399;3165
BA;ITAPE;588;37;130;720;5;4;85;1569
BA;ITAPEBI;635;66;151;390;8;2;104;1356
BA;ITAPETINGA;7900;531;1876;8015;122;82;1935;20461
BA;ITAPICURU;658;66;160;1047;70;7;200;2208
BA;ITAPITANGA;352;13;95;419;5;2;56;942
BA;ITAQUARA;518;45;145;346;16;3;55;1128
BA;ITARANTIM;1017;116;384;1663;8;7;179;3374
BA;ITATIM;1579;261;397;1885;38;9;602;4771
BA;ITIRUCU;1259;133;259;1017;25;5;247;2945
BA;ITIUBA;2134;161;558;3048;96;9;473;6479
BA;ITORORO;1498;105;413;1114;28;12;418;3588
BA;ITUACU;1322;205;667;1884;67;14;433;4592
BA;ITUBERA;1703;166;562;2836;46;28;607;5948
BA;IUIU;558;55;236;1230;22;1;93;2195
BA;JABORANDI;442;104;331;1114;34;6;103;2134
BA;JACARACI;1209;59;351;597;39;13;136;2404
BA;JACOBINA;11987;856;3288;12664;298;170;2780;32043
BA;JAGUAQUARA;4869;697;1694;5528;90;61;1048;13987
BA;JAGUARARI;3168;330;911;2800;102;13;813;8137
BA;JAGUARIPE;630;56;201;901;42;4;165;1999
BA;JANDAIRA;304;26;68;378;18;8;70;872
BA;JEQUIE;23402;2022;5171;26780;440;304;10741;68860
BA;JEREMOABO;2182;101;556;4344;66;12;450;7711
BA;JIQUIRICA;1067;63;312;1850;26;2;219;3539
BA;JITAUNA;764;42;247;875;24;5;151;2108
BA;JOAO DOURADO;2443;184;539;1821;56;17;252;5312
BA;JUAZEIRO;38263;2946;10249;41500;1152;609;9347;104066
BA;JUCURUCU;287;20;120;908;8;4;62;1409
BA;JUSSARA;1181;76;343;1537;24;5;139;3305
BA;JUSSARI;310;17;106;411;5;0;36;885
BA;JUSSIAPE;589;68;286;1209;30;5;106;2293
BA;LAFAIETE COUTINHO;182;27;71;322;10;2;39;653
BA;LAGEDO DO TABOCAL;545;54;149;535;14;1;64;1362
BA;LAGOA REAL;1019;101;487;540;41;4;141;2333
BA;LAJE;1422;198;391;2505;57;9;530;5112
BA;LAJEDAO;402;9;86;239;14;4;71;825
BA;LAJEDINHO;157;12;59;222;17;0;47;514
BA;LAMARAO;339;14;42;520;10;2;128;1055
BA;LAPAO;2183;185;492;1846;59;17;210;4992
BA;LAURO DE FREITAS;46305;2515;7830;13153;772;1798;9648;82021
BA;LENCOIS;819;50;197;1557;7;25;276;2931
BA;LICINIO DE ALMEIDA;1328;132;367;1034;23;12;167;3063
BA;LIVRAMENTO DE NOSSA SENHORA;4744;581;2053;9586;160;73;832;18029
BA;LUIS EDUARDO MAGALHAES;17211;2066;6947;11901;298;896;14342;53661
BA;MACAJUBA;523;42;167;716;40;1;138;1627
BA;MACARANI;1144;97;345;1697;21;11;124;3439
BA;MACAUBAS;3681;295;1422;5763;279;60;1130;12630
BA;MACURURE;260;28;115;327;15;4;32;781
BA;MADRE DE DEUS;1808;108;299;487;34;28;670;3434
BA;MAETINGA;439;57;149;315;21;0;53;1034
BA;MAIQUINIQUE;478;56;216;818;19;5;79;1671
BA;MAIRI;1308;93;379;1186;48;6;210;3230
BA;MALHADA;589;52;236;1463;27;5;121;2493
BA;MALHADA DE PEDRAS;805;110;198;962;42;7;204;2328
BA;MANOEL VITORINO;685;78;238;531;26;3;201;1762
BA;MANSIDAO;199;27;127;263;14;2;30;662
BA;MARACAS;2611;297;888;2397;75;25;444;6737
BA;MARAGOGIPE;2281;183;366;2781;83;14;319;6027
BA;MARAU;344;49;207;739;13;25;102;1479
BA;MARCIONILIO SOUZA;602;49;185;594;19;4;108;1561
BA;MASCOTE;596;51;168;555;13;2;128;1513
BA;MATA DE SAO JOAO;4779;316;753;3692;170;78;1376;11164
BA;MATINA;736;31;226;676;38;1;91;1799
BA;MEDEIROS NETO;2207;114;660;2561;58;28;669;6297
BA;MIGUEL CALMON;2249;99;727;2174;50;9;377;5685
BA;MILAGRES;1123;185;230;781;21;5;274;2619
BA;MIRANGABA;696;77;259;1161;58;1;102;2354
BA;MIRANTE;367;78;213;390;23;1;98;1170
BA;MONTE SANTO;3211;329;1092;2618;217;18;527;8012
BA;MORPARA;202;23;164;248;10;0;95;742
BA;MORRO DO CHAPEU;3196;243;859;1475;40;22;464;6299
BA;MORTUGABA;1323;83;329;933;24;15;114;2821
BA;MUCUGE;1307;118;529;989;75;33;282;3333
BA;MUCURI;3367;150;641;1901;102;38;1944;8143
BA;MULUNGU DO MORRO;855;101;216;561;21;1;82;1837
BA;MUNDO NOVO;1458;75;324;1041;34;7;179;3118
BA;MUNIZ FERREIRA;670;61;109;631;13;5;164;1653
BA;MUQUEM DO SAO FRANCISCO;349;46;149;373;34;3;158;1112
BA;MURITIBA;2807;154;328;2916;45;19;787;7056
BA;MUTUIPE;2625;175;741;4102;72;18;833;8566
BA;NAZARE;2763;277;593;3373;59;19;701;7785
BA;NILO PECANHA;541;48;174;980;30;4;168;1945
BA;NORDESTINA;862;91;241;567;34;2;129;1926
BA;NOVA CANAA;702;77;232;597;20;4;111;1743
BA;NOVA FATIMA;881;91;148;811;14;3;189;2137
BA;NOVA IBIA;332;23;55;427;7;1;87;932
BA;NOVA ITARANA;473;37;77;279;9;4;51;930
BA;NOVA REDENCAO;349;24;107;506;10;10;42;1048
BA;NOVA SOURE;1583;83;247;1910;45;4;406;4278
BA;NOVA VICOSA;3409;177;762;2325;76;30;1215;7994
BA;NOVO HORIZONTE;1045;69;658;1805;26;13;174;3790
BA;NOVO TRIUNFO;346;20;73;854;4;4;94;1395
BA;OLINDINA;1701;109;270;1917;73;6;481;4557
BA;OLIVEIRA DOS BREJINHOS;1508;150;657;1770;63;11;365;4524
BA;OURICANGAS;364;29;56;265;26;2;68;810
BA;OUROLANDIA;1244;98;427;1395;17;13;234;3428
BA;PALMAS DE MONTE ALTO;1611;86;562;1857;57;3;125;4301
BA;PALMEIRAS;1016;54;305;808;11;29;182;2405
BA;PARAMIRIM;2540;241;801;2710;97;29;770;7188
BA;PARATINGA;1201;88;532;1793;63;14;260;3951
BA;PARIPIRANGA;952;72;245;4507;48;15;658;6497
BA;PAU BRASIL;485;53;202;945;43;2;131;1861
BA;PAULO AFONSO;23569;845;4346;18548;411;247;6836;54802
BA;PE DE SERRA;972;89;308;1257;36;8;205;2875
BA;PEDRAO;272;12;31;321;9;0;62;707
BA;PEDRO ALEXANDRE;209;6;60;527;13;1;22;838
BA;PIATA;1854;110;665;1114;42;28;415;4228
BA;PILAO ARCADO;581;49;454;896;8;10;298;2296
BA;PINDAI;1248;61;457;1273;52;3;142;3236
BA;PINDOBACU;1155;68;269;1973;36;7;232;3740
BA;PINTADAS;809;65;259;1120;59;5;116;2433
BA;PIRAI DO NORTE;445;33;148;1489;3;3;176;2297
BA;PIRIPA;854;101;255;776;30;7;124;2147
BA;PIRITIBA;1523;95;380;1300;28;9;328;3663
BA;PLANALTINO;631;68;203;434;34;1;85;1456
BA;PLANALTO;1710;145;431;1272;72;7;557;4194
BA;POCOES;5228;502;1334;4766;107;19;1806;13762
BA;POJUCA;4601;426;728;2772;84;46;2114;10771
BA;PONTO NOVO;1283;98;266;1403;42;3;203;3298
BA;PORTO SEGURO;18247;877;4369;18769;415;517;7814;51008
BA;POTIRAGUA;438;50;168;668;7;4;112;1447
BA;PRADO;1692;115;489;2274;52;14;686;5322
BA;PRESIDENTE DUTRA;1374;88;333;1501;14;11;244;3565
BA;PRESIDENTE JANIO QUADROS;613;64;221;548;30;3;83;1562
BA;PRESIDENTE TANCREDO NEVES;1919;358;775;3020;42;3;656;6773
BA;QUEIMADAS;1973;150;498;1934;78;15;389;5037
BA;QUIJINGUE;1098;77;251;1133;93;7;177;2836
BA;QUIXABEIRA;712;71;138;1055;20;1;132;2129
BA;RAFAEL JAMBEIRO;1291;88;243;1484;84;7;209;3406
BA;REMANSO;2106;175;1142;4412;29;30;998;8892
BA;RETIROLANDIA;1555;120;301;1678;26;15;510;4205
BA;RIACHAO DAS NEVES;914;79;340;1185;35;7;354;2914
BA;RIACHAO DO JACUIPE;3478;396;752;4377;43;36;1187;10269
BA;RIACHO DE SANTANA;2214;314;1006;2911;123;24;480;7072
BA;RIBEIRA DO AMPARO;623;15;95;1035;48;1;181;1998
BA;RIBEIRA DO POMBAL;5589;331;1205;6442;151;78;2660;16456
BA;RIBEIRAO DO LARGO;299;30;101;360;9;1;46;846
BA;RIO DE CONTAS;1137;82;490;1790;29;22;221;3771
BA;RIO DO ANTONIO;1389;224;448;636;26;4;193;2920
BA;RIO DO PIRES;1087;113;449;1496;24;7;326;3502
BA;RIO REAL;2478;248;555;5687;82;30;1046;10126
BA;RODELAS;597;41;214;1194;7;3;146;2202
BA;RUY BARBOSA;2474;168;487;2934;37;12;844;6956
BA;SALINAS DA MARGARIDA;662;27;115;323;16;7;117;1267
BA;SALVADOR;610461;18206;69349;140921;8948;15156;82264;945305
BA;SANTA BARBARA;1295;97;218;2004;38;11;614;4277
BA;SANTA BRIGIDA;714;29;180;1104;28;0;160;2215
BA;SANTA CRUZ CABRALIA;2480;120;613;2305;42;30;906;6496
BA;SANTA CRUZ DA VITORIA;282;17;57;174;5;3;43;581
BA;SANTA INES;793;42;151;546;6;6;156;1700
BA;SANTA LUZIA;488;42;186;613;6;3;72;1410
BA;SANTA MARIA DA VITORIA;3461;460;1456;6907;100;42;1303;13729
BA;SANTA RITA DE CASSIA;880;68;592;1929;20;7;570;4066
BA;SANTA TERESINHA;854;44;124;414;43;3;142;1624
BA;SANTALUZ;3300;378;870;2758;73;24;772;8175
BA;SANTANA;1579;184;589;4210;75;7;534;7178
BA;SANTANOPOLIS;609;31;85;707;17;2;135;1586
BA;SANTO AMARO;4316;281;711;4322;158;38;1288;11114
BA;SANTO ANTONIO DE JESUS;20688;2466;4229;17943;252;356;8062;53996
BA;SANTO ESTEVAO;6099;342;1044;8248;97;44;2526;18400
BA;SAO DESIDERIO;2043;369;932;2239;137;36;1340;7096
BA;SAO DOMINGOS;921;59;220;771;10;4;174;2159
BA;SAO FELIPE;1819;325;570;2959;69;20;498;6260
BA;SAO FELIX;1419;58;143;672;19;13;167;2491
BA;SAO FELIX DO CORIBE;1460;179;588;2909;37;7;574;5754
BA;SAO FRANCISCO DO CONDE;3016;162;385;2527;97;24;1720;7931
BA;SAO GABRIEL;1505;52;299;1469;38;9;209;3581
BA;SAO GONCALO DOS CAMPOS;3233;328;379;2657;69;32;1325;8023
BA;SAO JOSE DA VITORIA;374;19;82;356;8;1;38;878
BA;SAO JOSE DO JACUIPE;792;109;198;1023;10;2;192;2326
BA;SAO MIGUEL DAS MATAS;687;72;167;999;25;6;201;2157
BA;SAO SEBASTIAO DO PASSE;4237;256;747;2604;166;36;1534;9580
BA;SAPEACU;1852;123;285;2213;52;13;393;4931
BA;SATIRO DIAS;762;27;141;1045;21;7;215;2218
BA;SAUBARA;569;39;111;550;3;3;204;1479
BA;SAUDE;880;54;204;1077;24;6;171;2416
BA;SEABRA;6607;610;2105;8053;204;93;2369;20041
BA;SEBASTIAO LARANJEIRAS;505;38;216;692;31;2;88;1572
BA;SENHOR DO BONFIM;10306;727;2309;9507;252;131;2798;26030
BA;SENTO SE;552;55;321;2026;28;5;208;3195
BA;SERRA DO RAMALHO;1570;130;542;3736;71;9;367;6425
BA;SERRA DOURADA;747;83;358;2152;40;2;167;3549
BA;SERRA PRETA;831;60;133;1494;74;2;190;2784
BA;SERRINHA;12130;838;2016;13291;263;145;3448;32131
BA;SERROLANDIA;1173;81;269;1459;26;6;406;3420
BA;SIMOES FILHO;19167;2630;2806;7850;867;200;7646;41166
BA;SITIO DO MATO;306;39;148;894;29;2;81;1499
BA;SITIO DO QUINTO;496;20;93;1032;13;1;75;1730
BA;SOBRADINHO;2184;114;498;2366;32;11;384;5589
BA;SOUTO SOARES;1629;133;306;801;37;1;157;3064
BA;TABOCAS DO BREJO VELHO;490;47;172;1144;15;4;127;1999
BA;TANHACU;2126;321;813;2238;65;11;436;6010
BA;TANQUE NOVO;1801;297;800;1193;63;36;752;4942
BA;TANQUINHO;499;32;99;640;16;2;154;1442
BA;TAPEROA;991;167;478;1541;28;19;257;3481
BA;TAPIRAMUTA;925;64;213;524;23;1;126;1876
BA;TEIXEIRA DE FREITAS;23746;1717;6123;22402;416;350;11536;66290
BA;TEODORO SAMPAIO;380;15;68;316;16;0;68;863
BA;TEOFILANDIA;2160;138;327;2391;46;15;405;5482
BA;TEOLANDIA;778;178;368;1448;23;7;254;3056
BA;TERRA NOVA;740;28;88;408;21;1;121;1407
BA;TREMEDAL;1065;67;308;1027;58;2;201;2728
BA;TUCANO;3606;352;968;4639;130;49;1344;11088
BA;UAUA;1783;263;795;1503;45;6;243;4638
BA;UBAIRA;1632;139;429;1809;55;10;338;4412
BA;UBAITABA;2061;223;565;1857;27;30;729;5492
BA;UBATA;1558;224;383;1700;24;23;471;4383
BA;UIBAI;1386;75;293;917;24;4;145;2844
BA;UMBURANAS;767;74;276;669;25;3;124;1938
BA;UNA;1102;76;376;1345;197;19;244;3359
BA;URANDI;1583;154;589;2466;50;16;251;5109
BA;URUCUCA;1601;116;431;1455;19;22;282;3926
BA;UTINGA;1264;89;468;1104;26;8;282;3241
BA;VALENCA;9108;909;2379;9853;175;147;4791;27362
BA;VALENTE;3351;212;766;1797;43;28;700;6897
BA;VARZEA DA ROCA;955;70;291;1221;27;3;195;2762
BA;VARZEA DO POCO;744;110;215;1008;14;3;169;2263
BA;VARZEA NOVA;1132;78;360;823;23;7;187;2610
BA;VARZEDO;626;92;165;1038;36;1;133;2091
BA;VERA CRUZ;2958;215;453;1945;76;42;829;6518
BA;VEREDA;318;12;133;698;3;0;72;1236
BA;VITORIA DA CONQUISTA;66361;5074;14298;41415;1812;1194;17789;147943
BA;WAGNER;493;49;169;353;17;6;72;1159
BA;WANDERLEY;596;88;322;1136;22;9;198;2371
BA;WENCESLAU GUIMARAES;990;144;376;1991;27;6;324;3858
BA;XIQUE-XIQUE;2244;186;1060;4968;41;22;665;9186
CE;ABAIARA;592;65;178;1659;9;2;148;2653
CE;ACARAPE;1110;109;129;1249;109;10;155;2871
CE;ACARAU;3598;281;1569;9023;81;88;2236;16876
CE;ACOPIARA;3340;428;1010;10365;80;46;1371;16640
CE;AIUABA;456;37;173;2241;9;1;171;3088
CE;ALCANTARAS;709;59;196;2488;30;11;647;4140
CE;ALTANEIRA;378;42;109;1088;8;2;146;1773
CE;ALTO SANTO;846;160;257;2702;26;8;540;4539
CE;AMONTADA;1803;217;694;5549;49;34;733;9079
CE;ANTONINA DO NORTE;504;73;150;1526;8;2;146;2409
CE;APUIARES;839;103;223;2713;22;8;271;4179
CE;AQUIRAZ;9903;911;1401;9378;144;310;1559;23606
CE;ARACATI;7989;633;1518;9537;173;197;4323;24370
CE;ARACOIABA;1787;139;310;3864;36;9;277;6422
CE;ARARENDA;543;40;210;2279;36;3;267;3378
CE;ARARIPE;1413;147;469;3953;75;2;267;6326
CE;ARATUBA;559;94;205;2248;25;8;65;3204
CE;ARNEIROZ;300;45;121;1319;5;0;126;1916
CE;ASSARE;1115;125;450;3992;17;12;444;6155
CE;AURORA;1250;134;392;3879;20;20;303;5998
CE;BAIXIO;524;27;120;768;20;3;120;1582
CE;BANABUIU;901;214;308;2387;34;5;308;4157
CE;BARBALHA;6699;449;1617;10568;110;124;2040;21607
CE;BARREIRA;2234;181;473;3525;25;18;542;6998
CE;BARRO;1548;123;349;2590;21;8;586;5225
CE;BARROQUINHA;487;72;296;1935;9;8;354;3161
CE;BATURITE;2703;253;625;6361;44;34;833;10853
CE;BEBERIBE;5762;350;1023;4897;119;91;965;13207
CE;BELA CRUZ;1775;149;646;5027;55;25;705;8382
CE;BOA VIAGEM;3718;666;1022;13526;98;59;1295;20384
CE;BREJO SANTO;5686;632;2035;10351;73;116;2083;20976
CE;CAMOCIM;3946;267;1447;10572;44;173;2978;19427
CE;CAMPOS SALES;2250;270;751;7431;72;18;854;11646
CE;CANINDE;6050;694;1393;16483;275;79;3013;27987
CE;CAPISTRANO;1069;84;215;2534;23;8;257;4190
CE;CARIDADE;1142;90;228;3049;21;15;181;4726
CE;CARIRE;994;95;279;3484;35;5;359;5251
CE;CARIRIACU;1743;107;694;5058;18;9;475;8104
CE;CARIUS;783;60;313;2806;9;10;580;4561
CE;CARNAUBAL;1304;86;306;2123;14;11;818;4662
CE;CASCAVEL;9062;609;1217;8377;196;168;2105;21734
CE;CATARINA;591;61;262;2577;2;14;187;3694
CE;CATUNDA;542;55;112;1402;8;4;182;2305
CE;CAUCAIA;45308;2247;5145;38831;504;755;5742;98532
CE;CEDRO;1648;129;503;5598;46;7;875;8806
CE;CHAVAL;309;44;156;1609;11;7;467;2603
CE;CHORO;498;83;98;2050;94;4;100;2927
CE;CHOROZINHO;2723;168;440;2269;49;18;524;6191
CE;COREAU;1185;125;286;3239;39;17;840;5731
CE;CRATEUS;7195;452;2051;18213;154;141;4911;33117
CE;CRATO;18508;1217;3740;24433;175;288;5832;54193
CE;CROATA;1336;80;360;3015;18;12;572;5393
CE;CRUZ;2439;221;1159;5128;149;117;1321;10534
CE;DEPUTADO IRAPUAN PINHEIRO;479;28;150;2209;16;3;87;2972
CE;ERERE;174;9;60;838;6;4;89;1180
CE;EUSEBIO;11860;1845;2358;6785;178;939;2901;26866
CE;FARIAS BRITO;881;145;374;2874;28;10;264;4576
CE;FORQUILHA;1580;166;270;4390;51;20;1039;7516
CE;FORTALEZA;608423;22560;72083;310906;7001;25512;88863;1135348
CE;FORTIM;1566;60;308;1431;27;25;511;3928
CE;FRECHEIRINHA;1013;110;219;3373;32;15;1179;5941
CE;GENERAL SAMPAIO;372;33;83;1133;11;2;70;1704
CE;GRACA;600;37;193;2942;14;12;490;4288
CE;GRANJA;1779;277;1027;6466;49;33;1122;10753
CE;GRANJEIRO;175;22;57;285;5;2;24;570
CE;GROAIRAS;823;85;174;3433;32;11;641;5199
CE;GUAIUBA;1479;110;208;2391;16;19;214;4437
CE;GUARACIABA DO NORTE;4340;524;1252;7827;41;96;2614;16694
CE;GUARAMIRANGA;479;34;95;1135;13;10;119;1885
CE;HIDROLANDIA;1133;188;297;3393;23;19;805;5858
CE;HORIZONTE;8962;592;1102;10032;107;178;2228;23201
CE;IBARETAMA;740;147;130;1835;26;9;138;3025
CE;IBIAPINA;2154;242;535;3824;30;32;887;7704
CE;IBICUITINGA;759;105;170;2212;28;9;164;3447
CE;ICAPUI;965;133;265;4321;62;22;1110;6878
CE;ICO;4733;420;1218;15016;104;36;3198;24725
CE;IGUATU;12120;1158;3060;27443;195;254;7953;52183
CE;INDEPENDENCIA;1721;267;763;6508;30;20;1235;10544
CE;IPAPORANGA;584;47;204;2776;13;2;278;3904
CE;IPAUMIRIM;3670;332;1047;3718;41;23;784;9615
CE;IPU;3355;359;959;7201;33;58;2904;14869
CE;IPUEIRAS;2141;125;979;7317;17;32;1049;11660
CE;IRACEMA;875;72;270;3879;33;11;341;5481
CE;IRAUCUBA;1056;126;233;3334;46;9;415;5219
CE;ITAICABA;697;42;141;1820;17;3;291;3011
CE;ITAITINGA;4773;465;628;5905;103;68;1133;13075
CE;ITAPAJE;3575;383;813;10366;58;70;1273;16538
CE;ITAPIPOCA;8391;1064;2412;23145;147;232;4453;39844
CE;ITAPIUNA;1001;70;196;2490;33;5;190;3985
CE;ITAREMA;2178;195;1162;5205;49;58;864;9711
CE;ITATIRA;1230;229;274;2893;61;13;201;4901
CE;JAGUARETAMA;965;173;413;3822;29;8;387;5797
CE;JAGUARIBARA;827;125;347;2640;17;8;626;4590
CE;JAGUARIBE;2866;439;1019;8582;40;49;1525;14520
CE;JAGUARUANA;2055;297;511;7607;34;35;1524;12063
CE;JARDIM;2102;212;863;5109;56;21;631;8994
CE;JATI;908;79;238;1007;27;11;364;2634
CE;JIJOCA DE JERICOACOARA;1958;117;1383;4771;22;317;920;9488
CE;JUAZEIRO DO NORTE;40259;2182;8257;57591;324;888;15789;125290
CE;JUCAS;1099;151;396;4638;40;16;694;7034
CE;LAVRAS DA MANGABEIRA;1636;144;440;4367;41;21;466;7115
CE;LIMOEIRO DO NORTE;8441;898;1542;14258;184;138;7121;32582
CE;MADALENA;1006;184;191;2923;45;15;221;4585
CE;MARACANAU;34743;2494;4066;28273;473;598;5461;76108
CE;MARANGUAPE;11418;759;1554;12368;313;225;1570;28207
CE;MARCO;1623;331;702;4548;36;53;647;7940
CE;MARTINOPOLE;390;42;153;1514;3;3;308;2413
CE;MASSAPE;1910;127;368;6301;117;29;1217;10069
CE;MAURITI;3086;207;1089;7273;82;25;930;12692
CE;MERUOCA;699;54;246;2730;31;9;538;4307
CE;MILAGRES;2265;134;431;3292;37;15;836;7010
CE;MILHA;884;101;277;3803;33;7;242;5347
CE;MIRAIMA;432;36;125;1677;13;4;118;2405
CE;MISSAO VELHA;2999;298;1189;6526;38;28;919;11997
CE;MOMBACA;2552;297;802;7590;51;55;1176;12523
CE;MONSENHOR TABOSA;986;108;301;3959;9;10;420;5793
CE;MORADA NOVA;6223;632;1348;13185;145;55;3583;25171
CE;MORAUJO;447;26;94;1448;11;7;177;2210
CE;MORRINHOS;1288;133;336;2946;28;32;724;5487
CE;MUCAMBO;787;53;228;2903;18;14;967;4970
CE;MULUNGU;509;79;126;1569;16;2;133;2434
CE;NOVA OLINDA;999;133;296;2550;16;12;442;4448
CE;NOVA RUSSAS;2744;231;610;7495;30;41;1333;12484
CE;NOVO ORIENTE;1781;88;665;7718;28;17;1492;11789
CE;OCARA;2164;214;425;3979;65;12;332;7191
CE;OROS;1226;159;589;3937;33;16;601;6561
CE;PACAJUS;10369;762;1335;9130;171;135;3158;25060
CE;PACATUBA;7611;343;731;7598;59;66;1034;17442
CE;PACOTI;706;111;183;2090;18;5;122;3235
CE;PACUJA;392;27;88;1225;9;1;296;2038
CE;PALHANO;816;100;197;2419;14;8;335;3889
CE;PALMACIA;523;53;124;1364;22;1;86;2173
CE;PARACURU;3764;251;635;4213;43;75;749;9730
CE;PARAIPABA;2696;328;505;4873;42;47;768;9259
CE;PARAMBU;1778;276;647;7190;25;15;1075;11006
CE;PARAMOTI;642;66;148;1991;25;5;102;2979
CE;PEDRA BRANCA;2674;606;725;9472;51;24;1369;14921
CE;PENAFORTE;910;138;281;2098;28;6;302;3763
CE;PENTECOSTE;2799;318;634;7246;41;58;1449;12545
CE;PEREIRO;1503;130;500;8704;43;21;363;11264
CE;PINDORETAMA;2334;192;457;2337;36;32;322;5710
CE;PIQUET CARNEIRO;738;69;257;2806;16;8;291;4185
CE;PIRES FERREIRA;447;27;133;1520;7;7;284;2425
CE;PORANGA;536;32;334;2365;10;4;337;3618
CE;PORTEIRAS;1107;104;433;2181;97;8;756;4686
CE;POTENGI;470;79;187;1546;10;6;125;2423
CE;POTIRETAMA;312;60;84;1300;8;0;118;1882
CE;QUITERIANOPOLIS;906;90;503;4719;8;10;929;7165
CE;QUIXADA;8389;1035;1492;16368;167;127;4917;32495
CE;QUIXELO;761;80;334;4046;44;7;267;5539
CE;QUIXERAMOBIM;5847;668;1204;15983;184;83;2901;26870
CE;QUIXERE;1997;315;405;5033;50;16;1718;9534
CE;REDENCAO;2495;267;415;4225;77;33;475;7987
CE;RERIUTABA;1309;128;335;3522;28;19;699;6040
CE;RUSSAS;8227;1089;1689;19659;195;160;6682;37701
CE;SABOEIRO;513;55;311;2602;12;4;300;3797
CE;SALITRE;633;190;220;1536;47;3;171;2800
CE;SANTA QUITERIA;2914;339;742;8497;45;54;1615;14206
CE;SANTANA DO ACARAU;1354;183;368;4367;65;25;1062;7424
CE;SANTANA DO CARIRI;873;97;340;2144;27;6;212;3699
CE;SAO BENEDITO;5073;550;1344;8173;103;102;3110;18455
CE;SAO GONCALO DO AMARANTE;6166;461;882;6536;154;99;1392;15690
CE;SAO JOAO DO JAGUARIBE;669;46;154;1965;10;3;655;3502
CE;SAO LUIS DO CURU;865;81;150;1665;15;4;267;3047
CE;SENADOR POMPEU;1805;212;456;5713;82;31;561;8860
CE;SENADOR SA;338;35;100;1029;18;3;131;1654
CE;SOBRAL;26018;1817;4505;46593;494;862;17247;97536
CE;SOLONOPOLE;1081;111;391;4455;27;14;260;6339
CE;TABULEIRO DO NORTE;3631;434;705;9020;57;40;5112;18999
CE;TAMBORIL;1617;156;502;5191;34;17;753;8270
CE;TARRAFAS;315;32;119;1420;10;3;230;2129
CE;TAUA;4745;601;1376;15040;65;82;2935;24844
CE;TEJUCUOCA;792;116;198;2510;31;6;118;3771
CE;TIANGUA;11197;1548;2959;15416;250;313;6768;38451
CE;TRAIRI;3142;308;890;6562;90;52;837;11881
CE;TURURU;992;77;281;2371;15;6;164;3906
CE;UBAJARA;3391;317;752;5978;91;61;1504;12094
CE;UMARI;379;14;75;675;8;0;82;1233
CE;UMIRIM;1122;61;160;1950;45;11;186;3535
CE;URUBURETAMA;819;107;255;3582;35;13;341;5152
CE;URUOCA;612;98;219;2178;20;7;342;3476
CE;VARJOTA;1720;174;491;4302;14;42;1103;7846
CE;VARZEA ALEGRE;3055;308;981;9915;68;43;1432;15802
CE;VICOSA DO CEARA;3017;481;1651;9708;99;69;2591;17616
DF;BRASILIA;1328622;24767;132643;198792;13305;31528;155263;1884920
ES;AFONSO CLAUDIO;8327;808;1874;6837;110;78;1986;20020
ES;AGUA DOCE DO NORTE;1713;159;441;2525;47;16;594;5495
ES;AGUIA BRANCA;1537;200;550;2423;63;8;748;5529
ES;ALEGRE;6997;311;1247;3882;48;102;1474;14061
ES;ALFREDO CHAVES;3971;558;1210;2363;49;66;2075;10292
ES;ALTO RIO NOVO;1325;141;351;1190;24;6;426;3463
ES;ANCHIETA;6271;425;1067;2367;79;126;2205;12540
ES;APIACA;2380;223;504;1134;11;48;479;4779
ES;ARACRUZ;21759;1586;3851;8470;528;340;8173;44707
ES;ATILIO VIVACQUA;2187;230;479;1985;29;26;495;5431
ES;BAIXO GUANDU;7577;584;1765;5483;104;80;2444;18037
ES;BARRA DE SAO FRANCISCO;8966;649;2103;8010;158;121;3699;23706
ES;BOA ESPERANCA;2039;280;619;2782;56;10;572;6358
ES;BOM JESUS DO NORTE;6439;419;1185;3165;40;165;1780;13193
ES;BREJETUBA;2758;373;705;2376;66;27;355;6660
ES;CACHOEIRO DE ITAPEMIRIM;58300;5399;9851;26033;1733;1256;14653;117225
ES;CARIACICA;87673;6441;11434;36531;1645;759;22067;166550
ES;CASTELO;10741;1415;3268;6205;113;292;4828;26862
ES;COLATINA;30589;2694;6709;15558;634;535;8766;65485
ES;CONCEICAO DA BARRA;3425;296;751;1818;151;47;984;7472
ES;CONCEICAO DO CASTELO;3430;338;1124;1920;71;41;846;7770
ES;DIVINO DE SAO LOURENCO;1078;93;206;840;14;11;117;2359
ES;DOMINGOS MARTINS;10460;1485;2901;8269;94;188;2285;25682
ES;DORES DO RIO PRETO;1994;181;417;978;19;28;275;3892
ES;ECOPORANGA;3075;213;806;3966;116;26;1061;9263
ES;FUNDAO;3998;364;869;1524;47;40;1029;7871
ES;GOVERNADOR LINDENBERG;1856;346;732;2744;7;12;875;6572
ES;GUACUI;9777;899;1813;4285;75;126;1740;18715
ES;GUARAPARI;37995;1515;7122;13979;304;2016;10743;73674
ES;IBATIBA;7034;695;1432;5699;91;79;979;16009
ES;IBIRACU;2735;404;645;1068;47;58;1010;5967
ES;IBITIRAMA;2097;184;395;1692;33;9;333;4743
ES;ICONHA;4314;552;1164;2970;77;68;3539;12684
ES;IRUPI;3111;289;887;2597;39;19;490;7432
ES;ITAGUACU;2868;333;887;2906;75;7;669;7745
ES;ITAPEMIRIM;6915;672;1341;4713;84;128;2359;16212
ES;ITARANA;2751;493;805;2489;46;25;769;7378
ES;IUNA;6865;585;1614;5189;83;71;1201;15608
ES;JAGUARE;4563;536;1447;5269;94;54;2448;14411
ES;JERONIMO MONTEIRO;2582;124;479;1882;23;9;701;5800
ES;JOAO NEIVA;4039;332;956;1408;38;49;1152;7974
ES;LARANJA DA TERRA;2604;370;451;3777;34;11;556;7803
ES;LINHARES;34174;3073;7497;17705;625;754;14482;78310
ES;MANTENOPOLIS;2466;232;697;1815;36;20;624;5890
ES;MARATAIZES;9125;1204;2935;5130;111;263;3257;22025
ES;MARECHAL FLORIANO;5238;923;1320;3369;57;111;1403;12421
ES;MARILANDIA;2544;450;860;3161;30;30;873;7948
ES;MIMOSO DO SUL;5700;398;1369;4251;95;134;1439;13386
ES;MONTANHA;2767;309;852;2223;133;43;847;7174
ES;MUCURICI;898;105;194;622;28;7;171;2025
ES;MUNIZ FREIRE;3974;316;972;3541;53;39;721;9616
ES;MUQUI;3238;233;780;2175;43;58;787;7314
ES;NOVA VENECIA;9343;1094;3100;8941;195;87;3442;26202
ES;PANCAS;3089;345;816;3556;29;25;651;8511
ES;PEDRO CANARIO;4199;813;1022;2294;363;25;1519;10235
ES;PINHEIROS;3454;343;902;2906;169;33;918;8725
ES;PIUMA;5265;326;1043;2221;16;179;2023;11073
ES;PONTO BELO;1013;68;222;780;21;5;269;2378
ES;PRESIDENTE KENNEDY;3219;430;893;2621;23;67;708;7961
ES;RIO BANANAL;3632;742;1714;5342;58;73;2385;13946
ES;RIO NOVO DO SUL;2594;372;596;2438;38;35;982;7055
ES;SANTA LEOPOLDINA;2502;524;718;2848;36;26;502;7156
ES;SANTA MARIA DE JETIBA;12454;3048;3798;10759;111;116;4951;35237
ES;SANTA TERESA;6797;863;1941;4843;129;127;1492;16192
ES;SAO DOMINGOS DO NORTE;1591;289;605;1828;54;12;865;5244
ES;SAO GABRIEL DA PALHA;6812;812;1861;7492;188;77;4389;21631
ES;SAO JOSE DO CALCADO;2859;113;479;1467;25;35;448;5426
ES;SAO MATEUS;23796;1407;5031;13331;452;396;8118;52531
ES;SAO ROQUE DO CANAA;2223;370;655;2883;40;10;645;6826
ES;SERRA;125329;9198;15422;32652;2283;1539;26335;212758
ES;SOORETAMA;3924;406;946;3149;70;25;955;9475
ES;VARGEM ALTA;5238;611;1489;3225;77;93;1134;11867
ES;VENDA NOVA DO IMIGRANTE;8601;903;2446;3674;131;247;2350;18352
ES;VIANA;14821;1475;2547;6447;393;93;7188;32964
ES;VILA PAVAO;1436;195;534;2694;32;7;615;5513
ES;VILA VALERIO;2553;449;1007;4622;114;26;1015;9786
ES;VILA VELHA;136701;4545;15879;38527;903;4153;31457;232165
ES;VITORIA;125519;4305;17659;23122;912;5723;25197;202437
GO;ABADIA DE GOIAS;2307;167;450;1097;14;22;689;4746
GO;ABADIANIA;2945;311;648;1204;36;28;760;5932
GO;ACREUNA;5118;462;1241;2353;132;65;2634;12005
GO;ADELANDIA;606;48;151;338;7;3;182;1335
GO;AGUA FRIA DE GOIAS;612;56;149;240;24;3;125;1209
GO;AGUA LIMPA;452;22;114;168;2;3;86;847
GO;AGUAS LINDAS DE GOIAS;15263;1367;2437;5726;746;83;8374;33996
GO;ALEXANIA;6954;557;1214;2307;55;51;2010;13148
GO;ALOANDIA;497;28;81;356;5;2;167;1136
GO;ALTO HORIZONTE;1117;76;265;594;26;12;518;2608
GO;ALTO PARAISO DE GOIAS;1214;88;444;583;18;66;309;2722
GO;ALVORADA DO NORTE;1977;182;403;902;19;11;559;4053
GO;AMARALINA;271;15;89;258;14;1;72;720
GO;AMERICANO DO BRASIL;1288;77;342;816;28;6;455;3012
GO;AMORINOPOLIS;642;41;181;528;12;1;208;1613
GO;ANAPOLIS;139906;10042;22676;54624;1758;2752;45489;277247
GO;ANHANGUERA;325;9;58;121;2;1;41;557
GO;ANICUNS;5688;403;1179;2489;101;23;2146;12029
GO;APARECIDA DE GOIANIA;145351;7680;17045;84952;732;1209;45685;302654
GO;APARECIDA DO RIO DOCE;661;74;167;255;11;5;183;1356
GO;APORE;927;119;265;311;35;10;287;1954
GO;ARACU;1005;38;215;515;14;3;306;2096
GO;ARAGARCAS;6998;507;1564;3883;33;61;2924;15970
GO;ARAGOIANIA;2152;111;440;1333;12;11;532;4591
GO;ARAGUAPAZ;1375;113;332;1068;19;5;645;3557
GO;ARENOPOLIS;482;28;196;329;10;5;133;1183
GO;ARUANA;992;85;233;849;24;9;619;2811
GO;AURILANDIA;742;36;168;415;3;1;155;1520
GO;AVELINOPOLIS;599;67;150;309;3;4;160;1292
GO;BALIZA;185;10;75;108;8;3;56;445
GO;BARRO ALTO;2308;192;548;776;89;18;1090;5021
GO;BELA VISTA DE GOIAS;7583;561;1939;5175;62;49;2991;18360
GO;BOM JARDIM DE GOIAS;1318;162;546;1195;38;11;884;4154
GO;BOM JESUS;6584;519;1486;2331;154;79;3896;15049
GO;BONFINOPOLIS;1547;77;333;900;11;4;415;3287
GO;BONOPOLIS;263;26;94;399;13;0;105;900
GO;BRAZABRANTES;732;69;133;336;8;1;210;1489
GO;BRITANIA;1262;106;290;665;14;11;506;2854
GO;BURITI ALEGRE;3192;250;660;897;20;26;918;5963
GO;BURITI DE GOIAS;753;29;203;587;2;3;209;1786
GO;BURITINOPOLIS;504;32;73;294;9;0;94;1006
GO;CABECEIRAS;1534;165;319;541;32;2;342;2935
GO;CACHOEIRA ALTA;2588;183;679;1012;77;14;784;5337
GO;CACHOEIRA DE GOIAS;300;10;69;134;2;1;66;582
GO;CACHOEIRA DOURADA;2049;130;341;681;49;6;773;4029
GO;CACU;3591;335;1160;1386;49;44;1487;8052
GO;CAIAPONIA;3599;302;1303;1669;16;37;1495;8421
GO;CALDAS NOVAS;25642;904;5060;18731;134;311;14992;65774
GO;CALDAZINHA;734;39;248;778;3;4;183;1989
GO;CAMPESTRE DE GOIAS;697;49;167;488;8;9;220;1638
GO;CAMPINACU;529;48;174;470;6;7;139;1373
GO;CAMPINORTE;2672;213;677;1613;26;40;1032;6273
GO;CAMPO ALEGRE DE GOIAS;1516;190;481;515;31;12;480;3225
GO;CAMPO LIMPO DE GOIAS;1268;212;392;582;7;7;364;2832
GO;CAMPOS BELOS;4370;331;1396;3334;62;32;1505;11030
GO;CAMPOS VERDES;689;51;116;604;3;3;230;1696
GO;CARMO DO RIO VERDE;2113;131;430;1482;55;10;893;5114
GO;CASTELANDIA;651;71;146;327;12;3;249;1459
GO;CATALAO;37246;2182;9619;16846;419;2018;14870;83200
GO;CATURAI;1111;58;432;526;10;3;328;2468
GO;CAVALCANTE;653;58;321;567;6;27;137;1769
GO;CERES;8280;547;1874;5816;59;139;3580;20295
GO;CEZARINA;2058;163;401;1010;32;8;800;4472
GO;CHAPADAO DO CEU;2587;379;832;936;33;86;2149;7002
GO;CIDADE OCIDENTAL;6349;227;647;2613;130;25;1857;11848
GO;COCALZINHO DE GOIAS;2825;245;694;970;39;26;784;5583
GO;COLINAS DO SUL;380;32;125;195;2;1;96;831
GO;CORREGO DO OURO;521;26;170;377;3;3;105;1205
GO;CORUMBA DE GOIAS;2057;126;512;1057;38;14;466;4270
GO;CORUMBAIBA;2064;180;602;1041;11;17;733;4648
GO;CRISTALINA;15009;1883;3734;4265;537;200;5504;31132
GO;CRISTIANOPOLIS;946;66;262;431;4;4;223;1936
GO;CRIXAS;3765;201;1083;2330;25;32;1391;8827
GO;CROMINIA;981;61;299;538;5;1;267;2152
GO;CUMARI;813;31;190;419;5;5;132;1595
GO;DAMIANOPOLIS;480;31;157;286;16;3;79;1052
GO;DAMOLANDIA;721;57;210;437;9;5;259;1698
GO;DAVINOPOLIS;451;35;171;177;6;0;70;910
GO;DIORAMA;365;19;141;398;8;2;114;1047
GO;DIVINOPOLIS DE GOIAS;398;42;111;207;10;4;109;881
GO;DOVERLANDIA;1504;152;709;1589;40;16;631;4641
GO;EDEALINA;916;87;246;503;14;3;301;2070
GO;EDEIA;3136;313;921;1467;27;37;1525;7426
GO;ESTRELA DO NORTE;599;42;169;643;4;5;191;1653
GO;FAINA;1058;71;306;716;11;3;280;2445
GO;FAZENDA NOVA;1031;53;297;1383;10;5;406;3185
GO;FIRMINOPOLIS;2623;125;578;1349;8;13;1030;5726
GO;FLORES DE GOIAS;546;61;153;475;17;1;151;1404
GO;FORMOSA;33847;3437;6947;12875;737;218;15583;73644
GO;FORMOSO;912;63;283;1006;9;4;318;2595
GO;GAMELEIRA DE GOIAS;497;44;198;258;19;0;109;1125
GO;GOIANAPOLIS;3047;255;756;1360;37;21;879;6355
GO;GOIANDIRA;1526;60;396;507;7;5;289;2790
GO;GOIANESIA;20058;1232;4257;9786;317;227;9053;44930
GO;GOIANIA;632078;25347;102831;242252;7118;15488;180372;1205486
GO;GOIANIRA;11003;470;1480;5616;111;72;3560;22312
GO;GOIAS;5934;263;1552;3410;65;58;1623;12905
GO;GOIATUBA;11493;859;2643;5135;154;144;6056;26484
GO;GOUVELANDIA;911;74;203;367;13;0;224;1792
GO;GUAPO;3394;300;648;1727;63;24;1366;7522
GO;GUARAITA;420;25;95;327;4;1;204;1076
GO;GUARANI DE GOIAS;426;18;133;378;11;2;121;1089
GO;GUARINOS;253;13;78;162;3;3;40;552
GO;HEITORAI;739;46;187;550;5;4;207;1738
GO;HIDROLANDIA;4897;932;1033;2758;53;40;1678;11391
GO;HIDROLINA;743;35;178;461;4;3;137;1561
GO;IACIARA;1485;156;442;1000;27;16;590;3716
GO;INACIOLANDIA;1029;76;203;589;19;3;431;2350
GO;INDIARA;3427;295;631;1347;45;11;1495;7251
GO;INHUMAS;16519;1222;4407;6920;216;190;9061;38535
GO;IPAMERI;6791;547;1923;2422;100;45;2411;14239
GO;IPIRANGA DE GOIAS;528;39;127;473;7;0;130;1304
GO;IPORA;10860;606;3368;7993;53;131;5212;28223
GO;ISRAELANDIA;483;45;117;360;8;1;117;1131
GO;ITABERAI;11876;1011;2791;6267;118;162;6111;28336
GO;ITAGUARI;1431;65;398;610;14;8;441;2967
GO;ITAGUARU;1429;111;551;894;12;6;398;3401
GO;ITAJA;1382;121;454;472;22;10;378;2839
GO;ITAPACI;4822;261;1029;3027;107;31;1656;10933
GO;ITAPIRAPUA;1537;86;444;1376;14;9;609;4075
GO;ITAPURANGA;7848;444;2050;6011;73;72;4039;20537
GO;ITARUMA;1066;104;498;517;21;9;348;2563
GO;ITAUCU;2077;137;547;650;14;9;557;3991
GO;ITUMBIARA;39203;2085;7830;16385;449;523;19510;85985
GO;IVOLANDIA;329;15;87;223;2;0;78;734
GO;JANDAIA;1422;127;421;792;19;7;477;3265
GO;JARAGUA;11520;516;2665;5442;53;75;5449;25720
GO;JATAI;31310;2549;9776;16612;309;661;16610;77827
GO;JAUPACI;544;30;136;503;7;1;165;1386
GO;JESUPOLIS;401;27;81;156;9;0;74;748
GO;JOVIANIA;1937;167;594;927;29;31;1047;4732
GO;JUSSARA;5772;495;1556;4772;28;58;3301;15982
GO;LAGOA SANTA;257;23;104;97;9;0;68;558
GO;LEOPOLDO DE BULHOES;1448;262;423;879;16;8;559;3595
GO;LUZIANIA;32561;2508;4814;13592;606;171;12308;66560
GO;MAIRIPOTABA;587;36;163;314;4;1;148;1253
GO;MAMBAI;1016;94;294;698;34;13;388;2537
GO;MARA ROSA;2005;162;712;1586;17;8;811;5301
GO;MARZAGAO;575;38;112;255;6;2;189;1177
GO;MATRINCHA;659;60;205;712;12;9;237;1894
GO;MAURILANDIA;2502;402;458;1191;128;13;1544;6238
GO;MIMOSO DE GOIAS;156;11;48;90;6;0;45;356
GO;MINACU;6445;516;1929;6817;54;107;3876;19744
GO;MINEIROS;17326;1476;5857;10818;183;264;8702;44626
GO;MOIPORA;361;9;96;159;1;3;35;664
GO;MONTE ALEGRE DE GOIAS;497;29;162;429;10;0;123;1250
GO;MONTES CLAROS DE GOIAS;1617;122;481;1431;37;14;567;4269
GO;MONTIVIDIU;3125;390;898;1193;82;38;1367;7093
GO;MONTIVIDIU DO NORTE;423;30;169;508;18;0;140;1288
GO;MORRINHOS;14382;985;2900;6890;166;109;7297;32729
GO;MORRO AGUDO DE GOIAS;555;68;149;501;8;0;99;1380
GO;MOSSAMEDES;1138;50;266;586;7;7;247;2301
GO;MOZARLANDIA;3170;169;794;2812;52;14;1502;8513
GO;MUNDO NOVO;1009;62;242;690;27;3;410;2443
GO;MUTUNOPOLIS;604;47;185;752;17;5;239;1849
GO;NAZARIO;1675;122;309;629;18;5;673;3431
GO;NEROPOLIS;8021;613;1574;3840;43;77;2927;17095
GO;NIQUELANDIA;9695;723;2510;3964;178;73;4160;21303
GO;NOVA AMERICA;618;40;165;409;4;2;118;1356
GO;NOVA AURORA;524;42;197;356;6;5;122;1252
GO;NOVA CRIXAS;1947;163;599;1576;44;11;922;5262
GO;NOVA GLORIA;1913;135;432;1235;31;7;668;4421
GO;NOVA IGUACU DE GOIAS;453;36;117;343;6;1;139;1095
GO;NOVA ROMA;344;10;87;232;6;1;49;729
GO;NOVA VENEZA;1872;178;444;912;27;24;617;4074
GO;NOVO BRASIL;701;35;231;680;5;4;268;1924
GO;NOVO GAMA;7607;497;976;2672;198;42;2155;14147
GO;NOVO PLANALTO;627;53;154;441;5;3;248;1531
GO;ORIZONA;4298;280;1678;2373;49;31;1252;9961
GO;OURO VERDE DE GOIAS;926;125;294;357;16;3;127;1848
GO;OUVIDOR;1699;77;440;539;17;15;420;3207
GO;PADRE BERNARDO;3727;461;972;1147;98;16;1189;7610
GO;PALESTINA DE GOIAS;462;28;145;464;13;2;149;1263
GO;PALMEIRAS DE GOIAS;6981;457;1745;3784;147;46;3370;16530
GO;PALMELO;530;36;113;268;6;1;122;1076
GO;PALMINOPOLIS;935;71;265;733;6;1;359;2370
GO;PANAMA;546;65;130;209;10;1;163;1124
GO;PARANAIGUARA;2547;136;513;660;15;18;884;4773
GO;PARAUNA;2806;225;899;1866;48;32;1403;7279
GO;PEROLANDIA;496;62;185;175;11;1;261;1191
GO;PETROLINA DE GOIAS;2118;219;524;970;23;14;489;4357
GO;PILAR DE GOIAS;402;31;130;209;7;4;60;843
GO;PIRACANJUBA;7298;534;2033;4043;49;47;3063;17067
GO;PIRANHAS;2724;253;884;2031;44;26;1300;7262
GO;PIRENOPOLIS;6138;349;1479;3717;43;65;1418;13209
GO;PIRES DO RIO;10342;634;2657;4452;78;80;3816;22059
GO;PLANALTINA;11469;739;1673;4165;422;58;4860;23386
GO;PONTALINA;4901;352;1248;2854;42;39;2306;11742
GO;PORANGATU;11515;812;3193;9632;98;99;8368;33717
GO;PORTEIRAO;850;124;167;245;49;5;316;1756
GO;PORTELANDIA;636;61;223;314;5;0;219;1458
GO;POSSE;8211;822;2197;3746;136;129;2848;18089
GO;PROFESSOR JAMIL;609;42;138;272;7;0;132;1200
GO;QUIRINOPOLIS;14370;1098;3690;7393;285;145;8856;35837
GO;RIALMA;3685;343;740;1928;46;33;1695;8470
GO;RIANAPOLIS;1211;101;245;756;10;6;421;2750
GO;RIO QUENTE;1006;55;227;426;59;9;320;2102
GO;RIO VERDE;60540;4164;15766;33032;633;1310;31051;146496
GO;RUBIATABA;5720;396;1355;3537;122;50;2321;13501
GO;SANCLERLANDIA;2428;137;628;1524;8;7;845;5577
GO;SANTA BARBARA DE GOIAS;1418;136;267;578;11;6;472;2888
GO;SANTA CRUZ DE GOIAS;451;17;119;167;4;2;69;829
GO;SANTA FE DE GOIAS;854;44;220;836;6;4;478;2442
GO;SANTA HELENA DE GOIAS;12159;1025;2602;4377;301;137;5705;26306
GO;SANTA ISABEL;523;17;142;487;6;5;156;1336
GO;SANTA RITA DO ARAGUAIA;1440;136;610;1488;15;18;902;4609
GO;SANTA RITA DO NOVO DESTINO;271;29;81;131;11;1;76;600
GO;SANTA ROSA DE GOIAS;806;46;206;390;5;3;137;1593
GO;SANTA TEREZA DE GOIAS;725;47;164;488;9;0;382;1815
GO;SANTA TEREZINHA DE GOIAS;1646;138;460;1715;24;16;676;4675
GO;SANTO ANTONIO DA BARRA;686;47;143;374;21;0;152;1423
GO;SANTO ANTONIO DE GOIAS;1540;107;320;577;23;10;450;3027
GO;SANTO ANTONIO DO DESCOBERTO;5487;336;709;2859;204;13;2268;11876
GO;SAO DOMINGOS;840;58;271;840;42;3;330;2384
GO;SAO FRANCISCO DE GOIAS;1190;58;271;645;14;5;326;2509
GO;SAO JOAO D'ALIANCA;1505;175;417;527;26;13;449;3112
GO;SAO JOAO DA PARAUNA;441;26;123;329;3;1;140;1063
GO;SAO LUIS DE MONTES BELOS;10543;517;2427;5915;105;85;4557;24149
GO;SAO LUIZ DO NORTE;821;73;209;522;25;5;320;1975
GO;SAO MIGUEL DO ARAGUAIA;5128;405;1721;3321;82;55;3164;13876
GO;SAO MIGUEL DO PASSA QUATRO;777;65;222;494;6;4;142;1710
GO;SAO PATRICIO;390;18;90;275;6;2;157;938
GO;SAO SIMAO;4204;247;892;1856;71;40;2203;9513
GO;SENADOR CANEDO;26612;1145;3078;16539;123;163;9212;56872
GO;SERRANOPOLIS;1368;142;592;530;25;13;561;3231
GO;SILVANIA;5498;481;1809;2795;60;56;1998;12697
GO;SIMOLANDIA;1159;168;313;618;14;7;425;2704
GO;SITIO D'ABADIA;240;14;86;151;8;3;43;545
GO;TAQUARAL DE GOIAS;901;36;228;369;9;4;246;1793
GO;TERESINA DE GOIAS;303;20;69;139;2;6;51;590
GO;TEREZOPOLIS DE GOIAS;1409;120;290;582;26;14;416;2857
GO;TRES RANCHOS;750;46;193;288;5;11;247;1540
GO;TRINDADE;30259;1406;4045;17851;186;186;11100;65033
GO;TROMBAS;458;46;153;668;14;0;170;1509
GO;TURVANIA;1208;67;284;656;9;5;372;2601
GO;TURVELANDIA;844;100;200;240;26;1;398;1809
GO;UIRAPURU;437;21;122;302;7;0;104;993
GO;URUACU;10844;734;2529;7063;105;150;7328;28753
GO;URUANA;3750;348;1106;2282;22;15;1527;9050
GO;URUTAI;760;33;198;340;11;2;213;1557
GO;VALPARAISO DE GOIAS;20654;800;2363;5991;296;134;6806;37044
GO;VARJAO;908;67;251;670;9;1;215;2121
GO;VIANOPOLIS;4683;624;1411;1693;56;41;1516;10024
GO;VICENTINOPOLIS;1860;217;521;1098;80;11;1425;5212
GO;VILA BOA;363;41;82;204;35;0;85;810
GO;VILA PROPICIO;434;49;148;195;30;3;127;986
MA;ACAILANDIA;10480;1835;3608;18622;293;112;8339;43289
MA;AFONSO CUNHA;68;10;35;490;7;1;59;670
MA;AGUA DOCE DO MARANHAO;64;5;54;480;11;1;47;662
MA;ALCANTARA;342;53;171;1253;64;6;178;2067
MA;ALDEIAS ALTAS;351;51;112;2135;27;1;295;2972
MA;ALTAMIRA DO MARANHAO;191;23;90;895;4;1;164;1368
MA;ALTO ALEGRE DO MARANHAO;698;75;190;2713;3;12;590;4281
MA;ALTO ALEGRE DO PINDARE;442;50;181;2661;4;4;155;3497
MA;ALTO PARNAIBA;158;93;227;1310;8;9;487;2292
MA;AMAPA DO MARANHAO;134;19;44;517;4;1;69;788
MA;AMARANTE DO MARANHAO;586;153;481;5979;11;5;777;7992
MA;ANAJATUBA;641;45;181;2448;13;10;349;3687
MA;ANAPURUS;460;64;236;1091;25;11;279;2166
MA;APICUM-ACU;178;19;112;574;5;2;187;1077
MA;ARAGUANA;253;21;76;926;8;1;114;1399
MA;ARAIOSES;126;34;68;1412;29;0;150;1819
MA;ARAME;360;124;309;4057;3;8;696;5557
MA;ARARI;1016;114;327;3982;14;7;1302;6762
MA;AXIXA;286;26;154;1633;16;3;117;2235
MA;BACABAL;7061;1051;2175;23148;95;143;7818;41491
MA;BACABEIRA;1023;137;276;1215;57;5;449;3162
MA;BACURI;210;16;92;599;8;2;151;1078
MA;BACURITUBA;31;5;30;621;6;0;67;760
MA;BALSAS;10338;2041;5130;25987;194;277;13677;57644
MA;BARAO DE GRAJAU;307;89;179;1889;12;4;439;2919
MA;BARRA DO CORDA;3350;807;2105;20670;28;92;4009;31061
MA;BARREIRINHAS;733;107;1270;5284;33;87;720;8234
MA;BELA VISTA DO MARANHAO;561;53;147;1546;5;4;192;2508
MA;BELAGUA;86;4;51;255;3;2;33;434
MA;BENEDITO LEITE;38;8;26;140;2;0;21;235
MA;BEQUIMAO;406;103;185;1975;21;4;405;3099
MA;BERNARDO DO MEARIM;131;38;78;1092;4;3;216;1562
MA;BOA VISTA DO GURUPI;138;14;35;314;3;2;39;545
MA;BOM JARDIM;822;155;332;4903;10;10;476;6708
MA;BOM JESUS DAS SELVAS;587;158;263;3456;11;6;318;4799
MA;BOM LUGAR;304;38;151;1606;13;7;151;2270
MA;BREJO;719;92;341;2090;14;11;389;3656
MA;BREJO DE AREIA;57;27;70;1132;6;0;86;1378
MA;BURITI;299;34;137;2784;20;1;372;3647
MA;BURITI BRAVO;297;52;181;2470;9;7;213;3229
MA;BURITICUPU;2015;506;879;11747;24;22;1751;16944
MA;BURITIRANA;269;39;178;1809;3;1;177;2476
MA;CACHOEIRA GRANDE;101;10;74;499;11;1;14;710
MA;CAJAPIO;137;10;36;859;4;0;84;1130
MA;CAJARI;215;12;85;1189;6;5;74;1586
MA;CAMPESTRE DO MARANHAO;632;50;211;1679;43;1;406;3022
MA;CANDIDO MENDES;94;17;68;926;3;2;88;1198
MA;CANTANHEDE;422;29;120;1277;9;4;263;2124
MA;CAPINZAL DO NORTE;346;40;128;1775;4;4;274;2571
MA;CAROLINA;1143;110;668;3447;14;28;1597;7007
MA;CARUTAPERA;210;49;128;1555;14;7;311;2274
MA;CAXIAS;9748;944;2420;34618;191;127;8039;56087
MA;CEDRAL;126;16;89;698;8;0;114;1051
MA;CENTRAL DO MARANHAO;86;13;58;413;4;0;53;627
MA;CENTRO DO GUILHERME;162;24;62;785;6;1;37;1077
MA;CENTRO NOVO DO MARANHAO;294;42;138;1285;11;6;68;1844
MA;CHAPADINHA;3379;409;1321;13328;27;105;3852;22421
MA;CIDELANDIA;519;67;219;2019;16;1;522;3363
MA;CODO;3474;735;1051;24965;56;36;5277;35594
MA;COELHO NETO;901;126;310;8196;50;9;1459;11051
MA;COLINAS;1023;199;575;6662;26;30;860;9375
MA;CONCEICAO DO LAGO-ACU;178;32;95;841;1;0;82;1229
MA;COROATA;1652;238;507;7222;32;34;1304;10989
MA;CURURUPU;414;46;215;2050;14;3;341;3083
MA;DAVINOPOLIS;565;103;104;1615;6;10;488;2891
MA;DOM PEDRO;1198;450;743;5163;41;18;1453;9066
MA;DUQUE BACELAR;94;6;39;712;9;4;68;932
MA;ESPERANTINOPOLIS;356;90;181;4313;5;9;502;5456
MA;ESTREITO;1784;268;817;5662;35;35;2263;10864
MA;FEIRA NOVA DO MARANHAO;176;26;137;880;8;1;105;1333
MA;FERNANDO FALCAO;63;23;118;739;10;0;62;1015
MA;FORMOSA DA SERRA NEGRA;357;57;452;2748;8;8;338;3968
MA;FORTALEZA DOS NOGUEIRAS;551;108;398;2553;11;17;597;4235
MA;FORTUNA;340;48;256;2089;4;9;236;2982
MA;GODOFREDO VIANA;108;11;59;678;11;1;90;958
MA;GONCALVES DIAS;483;74;205;1826;15;11;354;2968
MA;GOVERNADOR ARCHER;226;32;98;1194;9;3;199;1761
MA;GOVERNADOR EDISON LOBAO;879;106;274;1754;26;5;413;3457
MA;GOVERNADOR EUGENIO BARROS;456;53;209;1525;21;3;234;2501
MA;GOVERNADOR LUIZ ROCHA;192;22;130;792;5;3;58;1202
MA;GOVERNADOR NEWTON BELLO;210;20;81;1226;2;2;77;1618
MA;GOVERNADOR NUNES FREIRE;771;119;302;2473;7;10;402;4084
MA;GRACA ARANHA;248;17;119;849;4;2;173;1412
MA;GRAJAU;2753;577;1717;12677;69;40;2868;20701
MA;GUIMARAES;157;19;100;672;17;1;108;1074
MA;HUMBERTO DE CAMPOS;224;24;285;785;9;8;119;1454
MA;ICATU;247;31;147;1205;15;4;55;1704
MA;IGARAPE DO MEIO;469;44;104;1548;10;2;183;2360
MA;IGARAPE GRANDE;259;70;86;2058;8;6;367;2854
MA;IMPERATRIZ;47745;4572;12045;57541;596;873;36147;159519
MA;ITAIPAVA DO GRAJAU;128;31;90;839;9;3;58;1158
MA;ITAPECURU MIRIM;2770;410;746;7870;42;32;2433;14303
MA;ITINGA DO MARANHAO;1080;177;422;4352;19;10;2061;8121
MA;JATOBA;121;7;122;555;20;0;55;880
MA;JENIPAPO DOS VIEIRAS;149;66;159;1274;12;3;61;1724
MA;JOAO LISBOA;1308;157;454;3508;15;15;1046;6503
MA;JOSELANDIA;284;81;173;2646;8;2;403;3597
MA;JUNCO DO MARANHAO;160;16;37;526;6;0;54;799
MA;LAGO DA PEDRA;1406;299;685;12249;23;22;1895;16579
MA;LAGO DO JUNCO;177;18;76;1262;13;4;120;1670
MA;LAGO DOS RODRIGUES;277;54;129;2374;8;1;251;3094
MA;LAGO VERDE;389;36;136;1744;11;2;238;2556
MA;LAGOA DO MATO;87;29;101;1529;12;3;57;1818
MA;LAGOA GRANDE DO MARANHAO;98;38;68;1221;3;0;54;1482
MA;LAJEADO NOVO;216;26;150;808;5;0;151;1356
MA;LIMA CAMPOS;420;102;144;2362;13;9;568;3618
MA;LORETO;215;31;185;1093;11;6;220;1761
MA;LUIS DOMINGUES;61;6;32;513;4;1;76;693
MA;MAGALHAES DE ALMEIDA;121;19;60;794;13;3;99;1109
MA;MARACACUME;622;87;256;2759;9;15;515;4263
MA;MARAJA DO SENA;16;14;29;664;2;0;10;735
MA;MARANHAOZINHO;283;56;81;912;3;3;120;1458
MA;MATA ROMA;482;61;233;1469;24;9;300;2578
MA;MATINHA;436;59;247;2666;12;5;439;3864
MA;MATOES;302;48;146;2022;27;3;205;2753
MA;MATOES DO NORTE;172;22;47;382;6;0;67;696
MA;MILAGRES DO MARANHAO;59;11;37;203;10;3;24;347
MA;MIRADOR;261;52;240;1489;5;6;142;2195
MA;MIRANDA DO NORTE;991;158;314;1696;15;8;484;3666
MA;MIRINZAL;306;52;189;1457;8;8;343;2363
MA;MONCAO;369;37;151;2017;17;3;199;2793
MA;MONTES ALTOS;329;43;180;1198;3;0;156;1909
MA;MORROS;305;28;228;1571;9;5;118;2264
MA;NINA RODRIGUES;139;16;53;721;8;0;90;1027
MA;NOVA COLINAS;146;24;90;591;12;1;93;957
MA;NOVA IORQUE;101;16;73;315;2;3;58;568
MA;NOVA OLINDA DO MARANHAO;445;70;135;1641;8;5;285;2589
MA;OLHO D'AGUA DAS CUNHAS;752;75;310;3578;17;9;1002;5743
MA;OLINDA NOVA DO MARANHAO;226;47;161;1193;11;4;90;1732
MA;PACO DO LUMIAR;12288;520;2163;10126;189;169;2428;27883
MA;PALMEIRANDIA;267;22;122;1781;11;2;225;2430
MA;PARAIBANO;547;99;327;4010;7;13;653;5656
MA;PARNARAMA;247;54;171;1646;13;5;230;2366
MA;PASSAGEM FRANCA;266;56;234;2616;7;2;190;3371
MA;PASTOS BONS;630;153;323;2529;10;10;697;4352
MA;PAULINO NEVES;65;5;187;318;12;8;55;650
MA;PAULO RAMOS;455;84;180;3891;7;6;373;4996
MA;PEDREIRAS;2712;400;918;11377;46;76;3755;19284
MA;PEDRO DO ROSARIO;191;25;92;1795;10;0;101;2214
MA;PENALVA;380;44;163;2473;4;6;237;3307
MA;PERI MIRIM;256;27;94;1331;12;1;207;1928
MA;PERITORO;709;64;183;2629;14;4;475;4078
MA;PINDARE MIRIM;1315;98;276;4135;22;18;756;6620
MA;PINHEIRO;3938;526;1471;14724;109;92;4866;25726
MA;PIO XII;835;120;350;3631;9;9;751;5705
MA;PIRAPEMAS;256;26;86;1142;4;4;66;1584
MA;POCAO DE PEDRAS;354;64;189;4070;7;6;443;5133
MA;PORTO FRANCO;1469;146;540;3178;17;14;1347;6711
MA;PORTO RICO DO MARANHAO;71;5;53;435;3;0;48;615
MA;PRESIDENTE DUTRA;3411;550;1443;10348;30;91;3298;19171
MA;PRESIDENTE JUSCELINO;209;12;88;691;4;0;58;1062
MA;PRESIDENTE MEDICI;155;15;62;588;3;1;49;873
MA;PRESIDENTE SARNEY;120;17;85;1386;11;0;251;1870
MA;PRESIDENTE VARGAS;274;24;78;949;6;1;110;1442
MA;PRIMEIRA CRUZ;30;2;68;97;5;0;16;218
MA;RAPOSA;1492;139;485;2616;59;33;609;5433
MA;RIACHAO;660;121;344;2909;25;8;705;4772
MA;RIBAMAR FIQUENE;323;35;121;775;6;1;165;1426
MA;ROSARIO;1779;236;448;3758;53;24;1391;7689
MA;SAMBAIBA;91;27;76;455;10;0;86;745
MA;SANTA FILOMENA DO MARANHAO;155;11;149;677;6;1;90;1089
MA;SANTA HELENA;871;109;380;2881;22;9;931;5203
MA;SANTA INES;8162;890;2349;17450;119;134;5412;34516
MA;SANTA LUZIA;1852;312;780;8533;15;23;1992;13507
MA;SANTA LUZIA DO PARUA;945;136;331;3621;13;7;566;5619
MA;SANTA QUITERIA DO MARANHAO;419;53;311;1808;22;11;324;2948
MA;SANTA RITA;1453;191;417;5016;22;23;1094;8216
MA;SANTANA DO MARANHAO;69;13;100;347;9;1;41;580
MA;SANTO AMARO DO MARANHAO;26;6;207;160;5;4;23;431
MA;SANTO ANTONIO DOS LOPES;391;145;275;2496;13;7;469;3796
MA;SAO BENEDITO DO RIO PRETO;312;25;208;929;6;6;220;1706
MA;SAO BENTO;987;172;372;4999;25;16;805;7376
MA;SAO BERNARDO;465;87;240;2357;25;12;344;3530
MA;SAO DOMINGOS DO AZEITAO;160;63;144;603;4;6;187;1167
MA;SAO DOMINGOS DO MARANHAO;1395;299;1078;5370;25;29;932;9128
MA;SAO FELIX DE BALSAS;67;8;53;176;2;1;42;349
MA;SAO FRANCISCO DO BREJAO;325;67;164;1109;10;2;187;1864
MA;SAO FRANCISCO DO MARANHAO;35;10;34;229;2;4;6;320
MA;SAO JOAO BATISTA;309;35;128;2100;12;6;112;2702
MA;SAO JOAO DO CARU;107;36;93;1173;3;0;31;1443
MA;SAO JOAO DO PARAISO;291;47;246;1287;11;5;304;2191
MA;SAO JOAO DO SOTER;190;34;75;1117;14;1;135;1566
MA;SAO JOAO DOS PATOS;1410;222;653;7144;10;23;1093;10555
MA;SAO JOSE DE RIBAMAR;17036;920;3320;16746;378;358;3765;42523
MA;SAO JOSE DOS BASILIOS;130;18;141;942;6;0;73;1310
MA;SAO LUIS;209791;10709;38031;110223;4535;7179;37834;418302
MA;SAO LUIS GONZAGA DO MARANHAO;533;41;152;2582;10;5;214;3537
MA;SAO MATEUS DO MARANHAO;1407;136;417;5741;27;15;1883;9626
MA;SAO PEDRO DA AGUA BRANCA;288;24;110;1400;9;2;456;2289
MA;SAO PEDRO DOS CRENTES;113;59;131;601;7;1;92;1004
MA;SAO RAIMUNDO DAS MANGABEIRAS;779;179;403;2548;57;14;984;4964
MA;SAO RAIMUNDO DO DOCA BEZERRA;42;20;39;625;2;1;67;796
MA;SAO ROBERTO;64;16;38;892;4;0;34;1048
MA;SAO VICENTE FERRER;301;41;115;1772;5;5;169;2408
MA;SATUBINHA;151;20;80;747;2;0;55;1055
MA;SENADOR ALEXANDRE COSTA;186;30;84;1053;9;1;125;1488
MA;SENADOR LA ROCQUE;591;95;375;3754;5;6;405;5231
MA;SERRANO DO MARANHAO;59;6;35;245;8;0;38;391
MA;SITIO NOVO;381;90;377;2453;11;2;438;3752
MA;SUCUPIRA DO NORTE;147;33;138;1053;6;4;82;1463
MA;SUCUPIRA DO RIACHAO;95;12;64;695;6;1;66;939
MA;TASSO FRAGOSO;212;87;172;1050;7;1;351;1880
MA;TIMBIRAS;387;46;105;2482;10;6;520;3556
MA;TIMON;8885;741;1871;29868;171;59;6364;47959
MA;TRIZIDELA DO VALE;840;176;301;5284;15;12;1565;8193
MA;TUFILANDIA;171;11;50;582;1;0;38;853
MA;TUNTUM;1002;157;642;4520;21;16;1146;7504
MA;TURIACU;289;49;262;2312;8;7;225;3152
MA;TURILANDIA;315;17;122;1207;4;3;264;1932
MA;TUTOIA;395;96;468;2563;27;27;829;4405
MA;URBANO SANTOS;462;96;399;2146;27;17;265;3412
MA;VARGEM GRANDE;1002;156;391;4820;19;13;741;7142
MA;VIANA;1377;230;613;8001;11;25;1049;11306
MA;VILA NOVA DOS MARTIRIOS;365;55;134;1200;9;2;303;2068
MA;VITORIA DO MEARIM;1181;118;422;2878;12;21;619;5251
MA;VITORINO FREIRE;1111;138;522;6284;29;15;1111;9210
MA;ZE DOCA;1833;270;670;10356;53;20;1296;14498
MG;ABADIA DOS DOURADOS;2283;199;460;1063;20;8;359;4392
MG;ABAETE;7162;504;1330;2129;200;49;1638;13012
MG;ABRE CAMPO;2942;255;647;1857;55;26;434;6216
MG;ACAIACA;902;41;131;570;14;1;100;1759
MG;ACUCENA;1251;53;284;1687;48;2;116;3441
MG;AGUA BOA;1259;86;326;1984;45;5;175;3880
MG;AGUA COMPRIDA;509;40;113;142;13;0;104;921
MG;AGUANIL;1073;84;179;291;10;0;114;1751
MG;AGUAS FORMOSAS;2210;125;631;2290;51;17;400;5724
MG;AGUAS VERMELHAS;897;98;281;917;37;3;145;2378
MG;AIMORES;3828;207;538;3974;48;24;1352;9971
MG;AIURUOCA;1628;123;337;926;12;42;228;3296
MG;ALAGOA;511;42;127;350;20;12;64;1126
MG;ALBERTINA;972;61;246;389;8;7;93;1776
MG;ALEM PARAIBA;14405;1658;2284;5000;77;122;3016;26562
MG;ALFENAS;27987;1396;4652;9285;266;416;4198;48200
MG;ALFREDO VASCONCELOS;1534;188;335;902;36;10;365;3370
MG;ALMENARA;5097;326;1351;6039;171;41;1662;14687
MG;ALPERCATA;849;89;123;684;8;2;196;1951
MG;ALPINOPOLIS;7516;549;1245;2261;109;52;603;12335
MG;ALTEROSA;4481;323;842;2567;63;24;461;8761
MG;ALTO CAPARAO;1548;91;316;1045;25;10;211;3246
MG;ALTO JEQUITIBA;2511;115;569;1649;20;13;224;5101
MG;ALTO RIO DOCE;2047;148;378;2275;37;18;271;5174
MG;ALVARENGA;702;47;118;1059;21;4;46;1997
MG;ALVINOPOLIS;2872;245;620;2120;28;14;225;6124
MG;ALVORADA DE MINAS;565;29;128;482;24;6;75;1309
MG;AMPARO DA SERRA;821;58;137;861;50;3;86;2016
MG;ANDRADAS;15485;1178;3107;5983;122;263;2215;28353
MG;ANDRELANDIA;3204;168;485;852;29;24;358;5120
MG;ANGELANDIA;966;98;245;1260;38;0;146;2753
MG;ANTONIO CARLOS;2749;200;315;1212;49;14;397;4936
MG;ANTONIO DIAS;1600;138;225;1012;72;4;178;3229
MG;ANTONIO PRADO DE MINAS;400;19;58;308;5;2;116;908
MG;ARACAI;387;17;72;120;9;1;53;659
MG;ARACITABA;386;13;47;223;5;0;36;710
MG;ARACUAI;3582;299;1167;6969;148;41;1107;13313
MG;ARAGUARI;40953;2595;6790;20606;269;399;14114;85726
MG;ARANTINA;765;54;94;309;3;3;88;1316
MG;ARAPONGA;1164;81;254;1847;20;7;85;3458
MG;ARAPORA;1235;275;306;659;70;5;739;3289
MG;ARAPUA;752;65;200;428;21;5;121;1592
MG;ARAUJOS;2387;163;520;1060;13;20;467;4630
MG;ARAXA;40385;1884;7098;12162;387;624;7822;70362
MG;ARCEBURGO;3048;193;460;1022;77;13;429;5242
MG;ARCOS;14760;1361;2573;6458;305;121;4264;29842
MG;AREADO;5032;272;806;1118;95;38;504;7865
MG;ARGIRITA;525;29;103;171;10;2;71;911
MG;ARICANDUVA;402;29;111;765;18;2;54;1381
MG;ARINOS;2671;388;607;1774;144;11;735;6330
MG;ASTOLFO DUTRA;3307;269;566;1864;27;22;590;6645
MG;ATALEIA;1179;103;258;1411;49;5;181;3186
MG;AUGUSTO DE LIMA;689;37;128;351;20;5;95;1325
MG;BAEPENDI;5139;449;837;3096;35;77;826;10459
MG;BALDIM;1742;211;374;720;26;4;203;3280
MG;BAMBUI;8413;596;1942;2271;101;98;1184;14605
MG;BANDEIRA;259;23;67;468;17;2;42;878
MG;BANDEIRA DO SUL;1930;132;303;446;16;7;168;3002
MG;BARAO DE COCAIS;8869;544;1294;3602;151;95;1175;15730
MG;BARAO DO MONTE ALTO;755;61;99;703;15;7;141;1781
MG;BARBACENA;42362;1897;5138;13356;227;568;6020;69568
MG;BARRA LONGA;908;45;176;859;17;4;66;2075
MG;BARROSO;5877;446;678;2090;40;49;1634;10814
MG;BELA VISTA DE MINAS;3020;187;266;572;19;14;296;4374
MG;BELMIRO BRAGA;682;89;115;200;11;4;97;1198
MG;BELO HORIZONTE;1576738;36293;204144;236968;9420;31137;184868;2279568
MG;BELO ORIENTE;5065;275;712;2250;106;14;1057;9479
MG;BELO VALE;2215;341;451;1129;32;11;235;4414
MG;BERILO;937;91;281;2121;49;4;116;3599
MG;BERIZAL;467;47;132;709;14;2;106;1477
MG;BERTOPOLIS;261;12;57;335;9;0;34;708
MG;BETIM;118662;6029;14316;31805;1305;906;23981;197004
MG;BIAS FORTES;600;37;58;348;7;4;43;1097
MG;BICAS;4963;252;770;1103;45;58;774;7965
MG;BIQUINHAS;802;66;179;293;6;3;134;1483
MG;BOA ESPERANCA;13206;854;2112;4291;233;115;1676;22487
MG;BOCAINA DE MINAS;1474;132;323;999;17;37;208;3190
MG;BOCAIUVA;9899;636;2094;7371;247;102;1888;22237
MG;BOM DESPACHO;17314;1231;3348;5809;490;142;3184;31518
MG;BOM JARDIM DE MINAS;2232;171;303;787;24;16;287;3820
MG;BOM JESUS DA PENHA;1325;178;370;1107;19;13;142;3154
MG;BOM JESUS DO AMPARO;1487;100;303;521;22;4;144;2581
MG;BOM JESUS DO GALHO;1968;124;342;2344;28;6;189;5001
MG;BOM REPOUSO;3314;209;1185;1936;25;10;285;6964
MG;BOM SUCESSO;4702;228;698;1313;69;17;516;7543
MG;BONFIM;1747;170;372;1614;25;14;216;4158
MG;BONFINOPOLIS DE MINAS;1184;111;277;689;36;4;206;2507
MG;BONITO DE MINAS;311;58;185;718;38;3;86;1399
MG;BORDA DA MATA;5798;300;947;2051;71;62;591;9820
MG;BOTELHOS;5524;272;926;1558;53;50;591;8974
MG;BOTUMIRIM;348;43;166;563;36;5;73;1234
MG;BRAS PIRES;867;79;182;900;14;7;107;2156
MG;BRASILANDIA DE MINAS;3051;263;609;1846;174;7;834;6784
MG;BRASILIA DE MINAS;4660;337;831;4510;109;25;1349;11821
MG;BRASOPOLIS;4106;248;818;1745;52;54;422;7445
MG;BRAUNAS;570;29;148;655;24;4;81;1511
MG;BRUMADINHO;11846;1079;1896;4184;301;251;1813;21370
MG;BUENO BRANDAO;4169;247;891;1846;28;41;311;7533
MG;BUENOPOLIS;1756;121;371;1054;41;8;292;3643
MG;BUGRE;598;31;107;458;13;1;42;1250
MG;BURITIS;3975;351;907;2137;126;21;1328;8845
MG;BURITIZEIRO;3221;301;737;3581;147;7;957;8951
MG;CABECEIRA GRANDE;510;71;118;269;15;1;132;1116
MG;CABO VERDE;3699;208;603;931;53;10;310;5814
MG;CACHOEIRA DA PRATA;903;64;160;263;9;1;143;1543
MG;CACHOEIRA DE MINAS;2721;152;533;1110;24;22;318;4880
MG;CACHOEIRA DE PAJEU;887;42;154;635;21;2;108;1849
MG;CACHOEIRA DOURADA;513;18;82;197;5;2;211;1028
MG;CAETANOPOLIS;2585;179;384;1048;56;21;641;4914
MG;CAETE;12155;633;1655;4299;77;205;1688;20712
MG;CAIANA;868;61;131;793;12;6;101;1972
MG;CAJURI;686;85;133;735;14;4;133;1790
MG;CALDAS;4593;333;836;1128;36;33;570;7529
MG;CAMACHO;691;55;165;565;35;1;56;1568
MG;CAMANDUCAIA;7101;542;1327;3691;72;137;1073;13943
MG;CAMBUI;10612;720;2055;4298;114;109;1408;19316
MG;CAMBUQUIRA;3796;185;454;1282;44;25;443;6229
MG;CAMPANARIO;447;22;80;320;6;3;72;950
MG;CAMPANHA;4788;321;830;2118;68;29;762;8916
MG;CAMPESTRE;7420;611;1641;4173;83;30;797;14755
MG;CAMPINA VERDE;4887;281;1131;1921;58;23;1076;9377
MG;CAMPO AZUL;257;14;56;341;14;0;39;721
MG;CAMPO BELO;18118;1407;2526;6466;138;140;3363;32158
MG;CAMPO DO MEIO;2821;162;449;1057;85;13;463;5050
MG;CAMPO FLORIDO;1947;231;445;474;84;9;675;3865
MG;CAMPOS ALTOS;4474;400;1024;738;119;31;621;7407
MG;CAMPOS GERAIS;6886;489;1261;2564;166;33;631;12030
MG;CANA VERDE;1397;94;190;799;21;5;158;2664
MG;CANAA;831;69;179;1409;10;4;91;2593
MG;CANAPOLIS;2456;290;663;857;99;11;818;5194
MG;CANDEIAS;3922;309;815;2259;62;14;958;8339
MG;CANTAGALO;620;37;89;670;11;1;67;1495
MG;CAPARAO;1127;83;270;1115;17;5;110;2727
MG;CAPELA NOVA;1035;34;151;951;9;4;106;2290
MG;CAPELINHA;8582;874;2177;8765;219;99;1384;22100
MG;CAPETINGA;1989;216;337;357;46;9;371;3325
MG;CAPIM BRANCO;2355;103;394;810;13;13;388;4076
MG;CAPINOPOLIS;3691;315;715;1617;81;24;1670;8113
MG;CAPITAO ANDRADE;677;62;125;1035;11;0;166;2076
MG;CAPITAO ENEAS;1367;113;265;1473;36;6;333;3593
MG;CAPITOLIO;3382;187;876;1491;40;170;786;6932
MG;CAPUTIRA;2270;150;492;1966;61;5;281;5225
MG;CARAI;1025;100;310;1982;67;2;183;3669
MG;CARANAIBA;594;26;44;315;19;0;53;1051
MG;CARANDAI;8032;681;1066;2466;127;42;1641;14055
MG;CARANGOLA;7635;446;1182;4647;83;103;1152;15248
MG;CARATINGA;21073;1492;3586;12768;525;226;4016;43686
MG;CARBONITA;1846;184;474;1975;57;4;358;4898
MG;CAREACU;1523;133;276;349;20;13;230;2544
MG;CARLOS CHAGAS;2071;173;533;2565;61;12;459;5874
MG;CARMESIA;498;82;106;402;1305;1;156;2550
MG;CARMO DA CACHOEIRA;2739;198;396;682;62;19;476;4572
MG;CARMO DA MATA;2815;152;504;1479;63;14;459;5486
MG;CARMO DE MINAS;2549;163;407;1009;40;19;374;4561
MG;CARMO DO CAJURU;5972;479;1372;4105;117;35;1003;13083
MG;CARMO DO PARANAIBA;10932;792;2281;4252;139;87;2085;20568
MG;CARMO DO RIO CLARO;6974;458;1172;2056;107;47;803;11617
MG;CARMOPOLIS DE MINAS;5093;645;1031;3008;84;43;1024;10928
MG;CARNEIRINHO;2597;200;556;1196;81;4;640;5274
MG;CARRANCAS;955;59;231;276;12;18;101;1652
MG;CARVALHOPOLIS;1009;53;216;540;12;3;81;1914
MG;CARVALHOS;1050;93;210;623;12;7;126;2121
MG;CASA GRANDE;462;49;84;409;8;3;53;1068
MG;CASCALHO RICO;606;62;135;207;6;1;139;1156
MG;CASSIA;5818;493;1031;1347;86;50;1212;10037
MG;CATAGUASES;17634;898;2542;11978;183;219;4374;37828
MG;CATAS ALTAS;1631;140;266;348;10;17;182;2594
MG;CATAS ALTAS DA NORUEGA;549;62;110;582;14;3;60;1380
MG;CATUJI;705;50;165;634;30;0;128;1712
MG;CATUTI;549;45;100;918;33;1;72;1718
MG;CAXAMBU;7163;243;782;2282;34;99;987;11590
MG;CEDRO DO ABAETE;252;11;43;100;4;0;25;435
MG;CENTRAL DE MINAS;1180;104;217;1343;23;4;330;3201
MG;CENTRALINA;1439;154;321;564;23;8;663;3172
MG;CHACARA;547;51;104;311;21;5;85;1124
MG;CHALE;1115;95;216;1747;16;7;164;3360
MG;CHAPADA DO NORTE;564;55;212;1279;31;2;100;2243
MG;CHAPADA GAUCHA;989;217;495;1251;70;32;409;3463
MG;CHIADOR;1085;276;204;245;12;8;293;2123
MG;CIPOTANEA;850;73;217;1812;24;12;98;3086
MG;CLARAVAL;1159;118;286;411;26;9;203;2212
MG;CLARO DOS POCOES;833;95;260;849;55;9;137;2238
MG;CLAUDIO;9254;964;1773;4280;67;114;1531;17983
MG;COIMBRA;1686;146;352;1479;20;10;265;3958
MG;COLUNA;1149;69;269;1836;20;2;186;3531
MG;COMENDADOR GOMES;520;57;176;291;23;1;102;1170
MG;COMERCINHO;487;32;175;1022;25;0;54;1795
MG;CONCEICAO DA APARECIDA;3232;198;675;1484;39;25;336;5989
MG;CONCEICAO DA BARRA DE MINAS;852;50;132;601;13;2;106;1756
MG;CONCEICAO DAS ALAGOAS;6882;567;1061;2035;143;42;2178;12908
MG;CONCEICAO DAS PEDRAS;803;32;231;458;11;1;32;1568
MG;CONCEICAO DE IPANEMA;667;61;137;1064;8;3;73;2013
MG;CONCEICAO DO MATO DENTRO;3367;225;702;2214;211;62;512;7293
MG;CONCEICAO DO PARA;1392;91;243;837;21;8;244;2836
MG;CONCEICAO DO RIO VERDE;3016;222;479;914;49;21;413;5114
MG;CONCEICAO DOS OUROS;3040;275;573;896;20;15;292;5111
MG;CONEGO MARINHO;352;29;109;792;28;0;88;1398
MG;CONFINS;2583;226;406;771;47;18;590;4641
MG;CONGONHAL;3461;314;687;1657;16;20;423;6578
MG;CONGONHAS;17775;1099;2214;3871;165;188;3688;29000
MG;CONGONHAS DO NORTE;574;68;164;559;16;1;73;1455
MG;CONQUISTA;2116;174;327;324;43;17;342;3343
MG;CONSELHEIRO LAFAIETE;45281;1629;5008;16516;688;593;6129;75844
MG;CONSELHEIRO PENA;3529;260;686;3423;70;17;714;8699
MG;CONSOLACAO;306;17;61;151;5;0;21;561
MG;CONTAGEM;205481;14600;27466;51340;3016;1978;34214;338095
MG;COQUEIRAL;2584;144;407;1066;28;11;209;4449
MG;CORACAO DE JESUS;2713;245;790;2936;129;14;475;7302
MG;CORDISBURGO;1613;115;335;736;28;4;204;3035
MG;CORDISLANDIA;783;47;120;237;10;2;100;1299
MG;CORINTO;5300;403;1021;3002;104;20;1096;10946
MG;COROACI;984;94;224;1385;24;5;178;2894
MG;COROMANDEL;10129;772;2199;2438;119;67;1954;17678
MG;CORONEL FABRICIANO;28415;1217;3085;12601;590;222;4037;50167
MG;CORONEL MURTA;714;42;187;1365;20;6;139;2473
MG;CORONEL PACHECO;501;33;69;98;8;1;54;764
MG;CORONEL XAVIER CHAVES;761;91;100;357;4;7;86;1406
MG;CORREGO DANTA;824;60;216;161;20;1;135;1417
MG;CORREGO DO BOM JESUS;1083;54;206;625;15;7;110;2100
MG;CORREGO FUNDO;1777;376;269;684;36;2;360;3504
MG;CORREGO NOVO;353;18;58;467;10;0;46;952
MG;COUTO DE MAGALHAES DE MINAS;835;68;188;370;14;6;77;1558
MG;CRISOLITA;301;16;72;432;12;0;56;889
MG;CRISTAIS;3502;198;648;1522;30;18;267;6185
MG;CRISTALIA;400;44;140;852;32;0;59;1527
MG;CRISTIANO OTONI;1627;147;227;646;31;3;265;2946
MG;CRISTINA;2047;108;364;1051;25;18;248;3861
MG;CRUCILANDIA;1469;169;295;1140;20;18;173;3284
MG;CRUZEIRO DA FORTALEZA;902;120;258;437;18;5;125;1865
MG;CRUZILIA;4881;421;896;1890;72;38;532;8730
MG;CUPARAQUE;541;70;122;821;7;2;184;1747
MG;CURRAL DE DENTRO;727;78;178;916;23;2;180;2104
MG;CURVELO;19616;1389;3843;12277;1517;163;6567;45372
MG;DATAS;978;56;267;354;23;1;58;1737
MG;DELFIM MOREIRA;1349;90;286;864;30;22;215;2856
MG;DELFINOPOLIS;1778;149;418;503;28;35;215;3126
MG;DELTA;2791;533;403;616;191;12;1171;5717
MG;DESCOBERTO;1149;41;161;662;4;5;124;2146
MG;DESTERRO DE ENTRE RIOS;1994;147;320;1673;30;8;195;4367
MG;DESTERRO DO MELO;786;47;120;833;21;7;67;1881
MG;DIAMANTINA;12010;485;2393;6118;338;256;1149;22749
MG;DIOGO DE VASCONCELOS;502;22;95;640;12;0;45;1316
MG;DIONISIO;1224;46;204;698;24;7;95;2298
MG;DIVINESIA;635;106;140;471;13;4;111;1480
MG;DIVINO;4949;310;987;3910;60;33;508;10757
MG;DIVINO DAS LARANJEIRAS;604;59;115;529;10;5;90;1412
MG;DIVINOLANDIA DE MINAS;1308;98;267;1224;20;3;183;3103
MG;DIVINOPOLIS;81700;3411;11440;30601;779;1130;16477;145538
MG;DIVISA ALEGRE;557;73;107;368;12;2;116;1235
MG;DIVISA NOVA;1640;104;259;471;49;4;196;2723
MG;DIVISOPOLIS;549;72;166;457;14;1;87;1346
MG;DOM BOSCO;523;31;123;617;16;0;152;1462
MG;DOM CAVATI;1521;173;253;941;18;9;251;3166
MG;DOM JOAQUIM;544;33;138;533;13;3;43;1307
MG;DOM SILVERIO;1157;80;208;876;14;3;76;2414
MG;DOM VICOSO;621;36;155;415;16;1;76;1320
MG;DONA EUZEBIA;1383;343;475;1025;9;12;370;3617
MG;DORES DE CAMPOS;3184;143;499;1506;43;30;429;5834
MG;DORES DE GUANHAES;672;55;141;854;27;3;95;1847
MG;DORES DO INDAIA;4705;268;1008;1032;27;31;681;7752
MG;DORES DO TURVO;1202;88;226;1322;23;5;206;3072
MG;DORESOPOLIS;325;15;116;156;7;0;48;667
MG;DOURADOQUARA;470;36;106;184;4;2;73;875
MG;DURANDE;1528;119;359;1712;33;5;179;3935
MG;ELOI MENDES;7477;651;1293;2692;65;47;1052;13277
MG;ENGENHEIRO CALDAS;1739;166;313;1097;20;11;281;3627
MG;ENGENHEIRO NAVARRO;943;76;177;599;28;13;159;1995
MG;ENTRE FOLHAS;887;77;179;1257;17;2;89;2508
MG;ENTRE RIOS DE MINAS;4784;319;797;2515;70;33;602;9120
MG;ERVALIA;4899;388;986;4432;93;32;567;11397
MG;ESMERALDAS;11002;600;1487;3605;333;41;1154;18222
MG;ESPERA FELIZ;6398;435;1149;4529;63;49;877;13500
MG;ESPINOSA;4277;398;1262;8675;136;28;1371;16147
MG;ESPIRITO SANTO DO DOURADO;1380;123;338;638;15;2;121;2617
MG;ESTIVA;3178;311;961;1499;30;21;738;6738
MG;ESTRELA DALVA;494;34;64;181;5;3;76;857
MG;ESTRELA DO INDAIA;900;53;213;248;7;2;90;1513
MG;ESTRELA DO SUL;1534;129;250;471;22;4;335;2745
MG;EUGENOPOLIS;2535;164;321;1683;39;14;420;5176
MG;EWBANK DA CAMARA;667;50;78;176;6;3;83;1063
MG;EXTREMA;13632;592;1910;4344;212;181;2024;22895
MG;FAMA;437;18;84;116;2;3;82;742
MG;FARIA LEMOS;559;28;97;380;3;5;75;1147
MG;FELICIO DOS SANTOS;848;54;179;786;33;4;117;2021
MG;FELISBURGO;813;28;165;1048;18;4;81;2157
MG;FELIXLANDIA;3077;267;503;1298;68;6;736;5955
MG;FERNANDES TOURINHO;441;23;78;432;12;1;70;1057
MG;FERROS;1619;128;335;1820;60;12;183;4157
MG;FERVEDOURO;2121;196;393;1617;23;8;186;4544
MG;FLORESTAL;2281;145;356;974;37;17;386;4196
MG;FORMIGA;23438;1837;4112;12683;247;222;4949;47488
MG;FORMOSO;539;62;183;476;42;2;99;1403
MG;FORTALEZA DE MINAS;1157;76;173;441;18;8;131;2004
MG;FORTUNA DE MINAS;587;38;120;261;13;3;85;1107
MG;FRANCISCO BADARO;515;57;192;1728;39;0;86;2617
MG;FRANCISCO DUMONT;611;86;154;539;40;8;79;1517
MG;FRANCISCO SA;2982;295;705;2867;142;26;671;7688
MG;FRANCISCOPOLIS;316;23;103;574;21;4;58;1099
MG;FREI GASPAR;428;33;79;726;19;0;74;1359
MG;FREI INOCENCIO;1233;99;221;1081;30;4;203;2871
MG;FREI LAGONEGRO;404;13;87;744;16;2;51;1317
MG;FRONTEIRA;3787;266;734;1619;99;25;1253;7783
MG;FRONTEIRA DOS VALES;309;15;72;387;7;0;41;831
MG;FRUTA DE LEITE;324;24;82;560;36;1;34;1061
MG;FRUTAL;20310;1696;4387;9152;239;191;8204;44179
MG;FUNILANDIA;784;63;139;388;29;1;114;1518
MG;GALILEIA;877;71;151;603;12;5;124;1843
MG;GAMELEIRAS;395;41;177;792;21;0;68;1494
MG;GLAUCILANDIA;109;8;27;170;8;1;12;335
MG;GOIABEIRA;469;42;58;734;5;0;115;1423
MG;GOIANA;1049;37;110;294;9;6;161;1666
MG;GONCALVES;1235;101;326;697;12;75;131;2577
MG;GONZAGA;1091;52;217;1267;14;4;206;2851
MG;GOUVEA;2753;144;579;1073;44;11;252;4856
MG;GOVERNADOR VALADARES;62945;3491;9484;45331;400;854;19250;141755
MG;GRAO MOGOL;1231;118;336;1325;93;6;206;3315
MG;GRUPIARA;308;16;75;166;5;0;47;617
MG;GUANHAES;8513;644;1913;6943;142;51;1170;19376
MG;GUAPE;4028;279;697;1924;78;25;334;7365
MG;GUARACIABA;1455;96;279;2065;52;7;171;4125
MG;GUARACIAMA;675;65;138;736;21;1;84;1720
MG;GUARANESIA;6804;436;984;2331;144;43;911;11653
MG;GUARANI;1623;90;270;677;17;16;223;2916
MG;GUARARA;1054;63;142;347;5;4;145;1760
MG;GUARDA-MOR;1579;154;501;404;42;13;380;3073
MG;GUAXUPE;20538;964;3028;6562;153;201;2807;34253
MG;GUIDOVAL;1408;176;275;1622;13;4;398;3896
MG;GUIMARANIA;2193;200;410;874;57;4;347;4085
MG;GUIRICEMA;1931;272;401;2380;25;10;367;5386
MG;GURINHATA;1062;122;312;561;37;3;216;2313
MG;HELIODORA;1474;97;288;616;22;3;145;2645
MG;IAPU;1979;186;342;1339;31;9;299;4185
MG;IBERTIOGA;1007;79;129;441;11;6;152;1825
MG;IBIA;6716;504;1331;1625;120;63;1905;12264
MG;IBIAI;631;64;243;928;15;3;128;2012
MG;IBIRACATU;441;20;82;796;19;0;57;1415
MG;IBIRACI;3544;440;819;669;55;52;527;6106
MG;IBIRITE;41483;1564;4137;14451;390;138;4455;66618
MG;IBITIURA DE MINAS;951;121;358;428;7;8;93;1966
MG;IBITURUNA;503;37;96;143;5;1;56;841
MG;ICARAI DE MINAS;518;39;140;1110;29;4;88;1928
MG;IGARAPE;13010;1069;1867;3305;200;101;2328;21880
MG;IGARATINGA;2450;572;530;1745;25;14;678;6014
MG;IGUATAMA;2356;143;406;531;20;10;322;3788
MG;IJACI;1601;232;242;535;28;6;612;3256
MG;ILICINEA;3795;290;654;1936;52;10;291;7028
MG;IMBE DE MINAS;793;59;198;1229;22;0;96;2397
MG;INCONFIDENTES;2139;94;438;905;39;15;232;3862
MG;INDAIABIRA;499;102;152;936;36;3;117;1845
MG;INDIANOPOLIS;1373;119;296;620;22;12;357;2799
MG;INGAI;456;20;115;180;15;0;63;849
MG;INHAPIM;5065;497;1163;4789;89;29;774;12406
MG;INHAUMA;1202;125;243;442;26;2;189;2229
MG;INIMUTABA;982;51;158;939;15;1;177;2323
MG;IPABA;2579;99;228;844;32;7;286;4075
MG;IPANEMA;4575;298;777;4120;57;32;1037;10896
MG;IPATINGA;89670;3362;9823;37191;766;926;13169;154907
MG;IPIACU;767;86;186;620;14;2;348;2023
MG;IPUIUNA;3771;468;827;912;45;34;437;6494
MG;IRAI DE MINAS;2134;271;553;732;41;28;544;4303
MG;ITABIRA;36751;1822;5335;12818;545;482;4491;62244
MG;ITABIRINHA;1694;184;320;2553;41;13;482;5287
MG;ITABIRITO;18573;1094;2594;6063;406;242;3631;32603
MG;ITACAMBIRA;92;18;50;152;10;0;12;334
MG;ITACARAMBI;1473;158;462;2878;66;8;570;5615
MG;ITAGUARA;4319;509;968;2642;106;47;1215;9806
MG;ITAIPE;1092;93;311;1519;31;2;250;3298
MG;ITAJUBA;29075;945;3627;10723;132;594;4418;49514
MG;ITAMARANDIBA;6809;820;1902;6479;196;36;1521;17763
MG;ITAMARATI DE MINAS;851;106;115;442;14;5;142;1675
MG;ITAMBACURI;2793;222;709;2585;63;19;589;6980
MG;ITAMBE DO MATO DENTRO;304;28;53;301;8;1;23;718
MG;ITAMOGI;3822;350;719;1072;51;14;586;6614
MG;ITAMONTE;4616;344;816;1981;41;73;843;8714
MG;ITANHANDU;5019;511;722;1632;35;68;1208;9195
MG;ITANHOMI;1912;137;379;2505;31;12;435;5411
MG;ITAOBIM;2760;244;692;2095;48;19;771;6629
MG;ITAPAGIPE;3760;307;907;1713;57;19;1158;7921
MG;ITAPECERICA;5420;422;919;2650;69;22;771;10273
MG;ITAPEVA;3450;275;651;1181;19;33;612;6221
MG;ITATIAIUCU;3483;367;587;867;50;18;834;6206
MG;ITAU DE MINAS;5536;322;733;1333;52;27;1676;9679
MG;ITAUNA;33489;1644;5615;12859;294;421;6511;60833
MG;ITAVERAVA;734;67;160;872;26;5;128;1992
MG;ITINGA;897;78;277;1299;49;5;207;2812
MG;ITUETA;770;82;197;1029;23;7;222;2330
MG;ITUIUTABA;29063;1520;5837;17494;370;278;14921;69483
MG;ITUMIRIM;1459;78;177;568;11;5;181;2479
MG;ITURAMA;12376;965;2595;5446;335;118;6094;27929
MG;ITUTINGA;1113;72;153;290;9;9;178;1824
MG;JABOTICATUBAS;3859;331;1004;2487;72;45;436;8234
MG;JACINTO;887;45;222;1033;50;6;161;2404
MG;JACUI;2671;193;552;1905;43;15;211;5590
MG;JACUTINGA;9109;484;1494;3004;99;114;1038;15342
MG;JAGUARACU;582;78;93;304;8;3;63;1131
MG;JAIBA;4434;480;1228;7336;222;25;1761;15486
MG;JAMPRUCA;349;21;54;508;31;2;45;1010
MG;JANAUBA;10896;926;2533;15007;199;111;6536;36208
MG;JANUARIA;7430;508;1962;13123;191;82;2947;26243
MG;JAPARAIBA;1102;108;247;735;22;3;199;2416
MG;JAPONVAR;895;71;239;854;25;0;116;2200
MG;JECEABA;1367;123;209;869;15;4;217;2804
MG;JENIPAPO DE MINAS;513;42;151;1359;37;4;122;2228
MG;JEQUERI;2191;158;532;2093;63;11;204;5252
MG;JEQUITAI;842;72;213;1038;37;3;215;2420
MG;JEQUITIBA;1023;101;239;548;46;3;145;2105
MG;JEQUITINHONHA;2033;115;473;2601;51;12;547;5832
MG;JESUANIA;1157;86;203;585;16;2;144;2193
MG;JOAIMA;1274;80;343;1512;44;5;253;3511
MG;JOANESIA;605;26;106;853;17;2;87;1696
MG;JOAO MONLEVADE;28141;1422;4867;6842;264;374;3876;45786
MG;JOAO PINHEIRO;12476;1278;2743;5106;379;107;3932;26021
MG;JOAQUIM FELICIO;509;51;143;223;19;2;67;1014
MG;JORDANIA;470;45;151;966;28;3;93;1756
MG;JOSE GONCALVES DE MINAS;456;31;177;1073;22;0;82;1841
MG;JOSE RAYDAN;534;42;105;854;18;0;66;1619
MG;JOSENOPOLIS;147;26;48;342;25;2;25;615
MG;JUATUBA;7873;373;1086;1715;285;48;1165;12545
MG;JUIZ DE FORA;183178;6501;17518;37229;1899;3478;27631;277434
MG;JURAMENTO;234;24;51;229;18;0;24;580
MG;JURUAIA;3176;133;671;2456;36;22;438;6932
MG;JUVENILIA;320;40;60;389;18;4;39;870
MG;LADAINHA;1103;69;273;1950;53;7;226;3681
MG;LAGAMAR;1936;130;398;730;25;4;417;3640
MG;LAGOA DA PRATA;17030;1321;2928;8411;178;266;5907;36041
MG;LAGOA DOS PATOS;353;40;124;391;18;3;48;977
MG;LAGOA DOURADA;3141;460;618;2998;182;24;631;8054
MG;LAGOA FORMOSA;5856;508;1360;1880;122;39;1057;10822
MG;LAGOA GRANDE;1845;159;383;1200;77;6;329;3999
MG;LAGOA SANTA;20013;900;2756;6388;122;382;3107;33668
MG;LAJINHA;4465;369;854;4147;74;18;666;10593
MG;LAMBARI;6916;464;1232;2858;41;69;1026;12606
MG;LAMIM;669;47;99;797;11;4;56;1683
MG;LARANJAL;1429;128;265;875;9;6;689;3401
MG;LASSANCE;754;62;209;585;18;4;126;1758
MG;LAVRAS;35437;1449;5177;15025;321;488;7876;65773
MG;LEANDRO FERREIRA;841;61;193;472;11;5;130;1713
MG;LEME DO PRADO;524;37;172;955;23;3;91;1805
MG;LEOPOLDINA;13352;799;1682;4614;110;134;2171;22862
MG;LIBERDADE;1773;170;255;587;15;13;187;3000
MG;LIMA DUARTE;4121;269;612;1336;37;66;589;7030
MG;LIMEIRA DO OESTE;2042;191;454;827;78;5;840;4437
MG;LONTRA;889;44;165;807;17;1;140;2063
MG;LUISBURGO;1388;72;422;1513;28;6;129;3558
MG;LUISLANDIA;399;27;107;410;24;0;82;1049
MG;LUMINARIAS;1539;157;266;795;44;8;102;2911
MG;LUZ;6193;403;1096;1691;43;37;1274;10737
MG;MACHACALIS;798;39;196;806;17;6;103;1965
MG;MACHADO;12036;873;2604;4600;148;151;2286;22698
MG;MADRE DE DEUS DE MINAS;1316;128;287;557;20;12;204;2524
MG;MALACACHETA;2363;135;673;2417;77;19;321;6005
MG;MAMONAS;893;118;244;1866;37;3;197;3358
MG;MANGA;1747;180;573;2381;70;9;448;5408
MG;MANHUACU;22135;1960;4311;10594;243;275;3199;42717
MG;MANHUMIRIM;6429;391;1152;3019;64;36;841;11932
MG;MANTENA;6133;580;1208;8631;93;21;2861;19527
MG;MAR DE ESPANHA;3596;297;601;1174;28;40;571;6307
MG;MARAVILHAS;1815;202;419;1170;16;8;394;4024
MG;MARIA DA FE;3047;291;613;1243;36;27;292;5549
MG;MARIANA;16232;777;2703;6379;353;286;2234;28964
MG;MARILAC;424;25;73;537;20;3;70;1152
MG;MARIO CAMPOS;4248;300;743;1061;26;20;553;6951
MG;MARIPA DE MINAS;927;76;153;376;6;7;141;1686
MG;MARLIERIA;825;50;143;489;15;5;90;1617
MG;MARMELOPOLIS;536;49;134;574;12;3;69;1377
MG;MARTINHO CAMPOS;3886;447;764;1477;91;20;1748;8433
MG;MARTINS SOARES;1774;195;393;1346;27;11;202;3948
MG;MATA VERDE;580;83;197;918;12;0;126;1916
MG;MATERLANDIA;476;24;121;730;6;0;53;1410
MG;MATEUS LEME;9531;635;1413;2662;116;67;1476;15900
MG;MATHIAS LOBATO;355;38;39;314;9;2;68;825
MG;MATIAS BARBOSA;3975;887;602;1022;54;50;1472;8062
MG;MATIAS CARDOSO;482;51;111;679;35;1;120;1479
MG;MATIPO;3797;357;861;1796;68;15;422;7316
MG;MATO VERDE;2040;193;462;5028;50;5;604;8382
MG;MATOZINHOS;10862;466;1502;2792;129;90;2708;18549
MG;MATUTINA;1114;100;362;427;11;5;107;2126
MG;MEDEIROS;1068;101;379;431;11;6;90;2086
MG;MEDINA;2534;188;609;1545;49;13;501;5439
MG;MENDES PIMENTEL;859;58;136;1156;18;4;162;2393
MG;MERCES;2493;213;422;1924;27;17;497;5593
MG;MESQUITA;886;33;158;627;17;0;74;1795
MG;MINAS NOVAS;2608;198;676;3874;134;22;342;7854
MG;MINDURI;933;92;157;355;9;10;142;1698
MG;MIRABELA;2083;230;477;1505;45;14;399;4753
MG;MIRADOURO;2095;117;347;1620;36;7;292;4514
MG;MIRAI;3208;197;546;2358;26;31;475;6841
MG;MIRAVANIA;243;19;82;445;20;1;25;835
MG;MOEDA;1738;115;323;731;64;17;199;3187
MG;MOEMA;2541;225;586;1543;133;19;687;5734
MG;MONJOLOS;94;12;32;106;10;0;7;261
MG;MONSENHOR PAULO;2432;215;354;736;16;9;252;4014
MG;MONTALVANIA;1465;189;510;2120;128;7;344;4763
MG;MONTE ALEGRE DE MINAS;5924;738;1720;1888;82;46;1651;12049
MG;MONTE AZUL;2984;204;852;5490;90;36;1129;10785
MG;MONTE BELO;4653;333;751;1991;66;30;531;8355
MG;MONTE CARMELO;18003;1575;3424;7824;218;140;4133;35317
MG;MONTE FORMOSO;450;36;109;636;58;1;96;1386
MG;MONTE SANTO DE MINAS;8428;589;1385;2798;130;46;1162;14538
MG;MONTE SIAO;8927;371;1793;4285;52;141;1402;16971
MG;MONTES CLAROS;94772;4827;16510;76600;1218;1480;26801;222208
MG;MONTEZUMA;568;74;199;1241;48;0;157;2287
MG;MORADA NOVA DE MINAS;1840;153;431;731;32;9;459;3655
MG;MORRO DA GARCA;344;44;71;216;21;1;53;750
MG;MORRO DO PILAR;408;44;101;475;5;0;34;1067
MG;MUNHOZ;2170;201;636;1233;15;13;200;4468
MG;MURIAE;27907;1578;3455;17009;226;331;6017;56523
MG;MUTUM;3890;293;778;5602;119;19;853;11554
MG;MUZAMBINHO;8663;579;1751;3610;60;65;948;15676
MG;NACIP RAYDAN;208;12;32;318;7;0;39;616
MG;NANUQUE;7004;577;1386;9622;245;35;2600;21469
MG;NAQUE;1076;47;143;504;20;3;133;1926
MG;NATALANDIA;493;33;69;426;25;0;99;1145
MG;NATERCIA;1315;108;271;800;24;2;140;2660
MG;NAZARENO;2508;257;425;874;48;20;312;4444
MG;NEPOMUCENO;8519;562;1276;2701;147;36;941;14182
MG;NINHEIRA;825;64;183;1290;54;2;174;2592
MG;NOVA BELEM;296;39;77;647;17;0;73;1149
MG;NOVA ERA;5156;284;719;1387;79;49;816;8490
MG;NOVA LIMA;29024;1876;4139;8970;309;1652;5168;51138
MG;NOVA MODICA;271;21;68;564;16;1;44;985
MG;NOVA PONTE;3981;320;744;786;90;38;1176;7135
MG;NOVA PORTEIRINHA;623;44;169;1203;22;3;299;2363
MG;NOVA RESENDE;6355;481;1422;4969;107;42;511;13887
MG;NOVA SERRANA;22628;651;4378;17023;150;306;5211;50347
MG;NOVA UNIAO;1617;210;409;651;29;13;187;3116
MG;NOVO CRUZEIRO;2436;257;893;5231;220;8;422;9467
MG;NOVO ORIENTE DE MINAS;780;44;226;1023;29;3;150;2255
MG;NOVORIZONTE;434;94;132;1012;29;0;54;1755
MG;OLARIA;430;23;71;216;14;6;62;822
MG;OLHOS-D'AGUA;744;125;255;678;62;4;162;2030
MG;OLIMPIO NORONHA;539;35;64;154;11;2;58;863
MG;OLIVEIRA;12148;889;1903;5000;134;116;2826;23016
MG;OLIVEIRA FORTES;335;27;33;199;11;1;55;661
MG;ONCA DE PITANGUI;409;27;87;357;18;0;52;950
MG;ORATORIOS;751;115;125;710;26;5;112;1844
MG;ORIZANIA;1661;104;277;1127;22;5;172;3368
MG;OURO BRANCO;14045;511;1577;4077;228;205;1719;22362
MG;OURO FINO;12726;760;1867;4452;150;114;1226;21295
MG;OURO PRETO;21899;1167;3106;7191;347;435;2792;36937
MG;OURO VERDE DE MINAS;690;35;193;1035;13;3;78;2047
MG;PADRE CARVALHO;394;35;69;436;35;2;43;1014
MG;PADRE PARAISO;2872;157;626;2614;87;17;507;6880
MG;PAI PEDRO;346;21;59;778;35;0;55;1294
MG;PAINEIRAS;1284;88;327;650;16;4;182;2551
MG;PAINS;2357;299;443;766;37;19;644;4565
MG;PAIVA;268;9;55;132;2;1;37;504
MG;PALMA;1272;126;230;960;11;7;268;2874
MG;PALMOPOLIS;327;30;126;983;22;2;58;1548
MG;PAPAGAIOS;3281;651;715;2466;92;12;950;8167
MG;PARA DE MINAS;28969;2501;5752;18407;259;359;9288;65535
MG;PARACATU;24868;1759;5043;9610;534;208;6592;48614
MG;PARAGUACU;6540;384;1293;2902;53;49;989;12210
MG;PARAISOPOLIS;6664;420;897;2203;48;69;794;11095
MG;PARAOPEBA;6567;514;1281;2568;55;32;2146;13163
MG;PASSA QUATRO;4912;433;655;1782;42;87;596;8507
MG;PASSA TEMPO;2556;241;433;947;31;8;401;4617
MG;PASSA VINTE;1395;435;343;330;22;15;293;2833
MG;PASSABEM;291;17;66;202;5;3;25;609
MG;PASSOS;37947;2291;6050;21096;532;958;6414;75288
MG;PATIS;424;35;121;465;20;4;66;1135
MG;PATOS DE MINAS;52144;3639;11521;28412;439;1010;17459;114624
MG;PATROCINIO;34017;2068;6118;11246;645;449;7116;61659
MG;PATROCINIO DO MURIAE;1359;122;183;967;11;4;244;2890
MG;PAULA CANDIDO;1597;96;305;1814;20;9;197;4038
MG;PAULISTAS;579;70;158;706;12;1;58;1584
MG;PAVAO;793;51;175;695;15;7;122;1858
MG;PECANHA;2672;158;561;2922;74;8;278;6673
MG;PEDRA AZUL;2821;202;626;2147;57;22;485;6360
MG;PEDRA BONITA;1410;101;420;1264;26;1;111;3333
MG;PEDRA DO ANTA;643;39;136;703;22;3;66;1612
MG;PEDRA DO INDAIA;983;118;265;460;11;6;181;2024
MG;PEDRA DOURADA;410;22;63;363;22;1;26;907
MG;PEDRALVA;3094;210;647;1383;31;22;262;5649
MG;PEDRAS DE MARIA DA CRUZ;647;44;176;981;42;1;138;2029
MG;PEDRINOPOLIS;1033;58;195;155;13;10;192;1656
MG;PEDRO LEOPOLDO;19309;1359;2634;6666;171;204;4007;34350
MG;PEDRO TEIXEIRA;435;18;52;226;6;1;37;775
MG;PEQUERI;921;81;133;267;6;11;216;1635
MG;PEQUI;812;72;167;773;7;3;141;1975
MG;PERDIGAO;2908;176;639;1871;17;19;627;6257
MG;PERDIZES;4618;383;1017;1020;86;36;913;8073
MG;PERDOES;7545;584;1228;2292;101;69;1491;13310
MG;PERIQUITO;801;59;139;450;31;3;96;1579
MG;PESCADOR;330;20;68;387;12;2;55;874
MG;PIAU;612;68;167;379;11;4;141;1382
MG;PIEDADE DE CARATINGA;1724;241;453;1531;31;5;293;4278
MG;PIEDADE DE PONTE NOVA;740;41;101;374;22;2;70;1350
MG;PIEDADE DO RIO GRANDE;979;65;174;456;8;3;117;1802
MG;PIEDADE DOS GERAIS;1197;127;245;1154;21;9;109;2862
MG;PIMENTA;2299;276;632;1819;33;21;435;5515
MG;PINGO D'AGUA;501;36;68;340;13;1;52;1011
MG;PINTOPOLIS;428;28;100;874;21;0;80;1531
MG;PIRACEMA;1721;148;367;1436;26;12;170;3880
MG;PIRAJUBA;1164;209;332;333;19;12;670;2739
MG;PIRANGA;2702;182;485;2548;99;18;272;6306
MG;PIRANGUCU;1009;76;212;725;33;17;143;2215
MG;PIRANGUINHO;2550;224;458;803;36;32;298;4401
MG;PIRAPETINGA;4191;641;545;2602;63;24;920;8986
MG;PIRAPORA;11664;645;2027;9035;222;115;3930;27638
MG;PIRAUBA;2296;142;398;1084;19;12;468;4419
MG;PITANGUI;8164;599;1448;5269;111;74;2276;17941
MG;PIUMHI;11999;953;2716;5692;109;314;2192;23975
MG;PLANURA;2798;193;485;726;86;13;953;5254
MG;POCO FUNDO;5300;380;1394;3866;39;33;597;11609
MG;POCOS DE CALDAS;71404;2952;9011;16668;517;971;11704;113227
MG;POCRANE;1228;100;206;1896;22;4;162;3618
MG;POMPEU;6584;516;1518;3218;165;41;2538;14580
MG;PONTE NOVA;17095;1245;2372;8203;178;188;2692;31973
MG;PONTO CHIQUE;211;12;78;366;9;1;16;693
MG;PONTO DOS VOLANTES;814;62;193;776;46;2;153;2046
MG;PORTEIRINHA;5782;500;1225;10577;278;36;1653;20051
MG;PORTO FIRME;1351;85;291;1452;32;9;166;3386
MG;POTE;1677;96;403;2075;45;6;379;4681
MG;POUSO ALEGRE;53814;3093;7862;15399;588;861;9365;90982
MG;POUSO ALTO;1689;118;247;563;19;12;274;2922
MG;PRADOS;2171;146;299;1805;22;26;330;4799
MG;PRATA;7691;517;1763;2867;126;47;2175;15186
MG;PRATAPOLIS;3215;279;469;909;36;11;543;5462
MG;PRATINHA;1045;95;342;588;13;7;104;2194
MG;PRESIDENTE BERNARDES;650;28;142;1192;13;1;72;2098
MG;PRESIDENTE JUSCELINO;520;60;166;325;24;2;88;1185
MG;PRESIDENTE KUBITSCHEK;499;31;100;365;11;4;50;1060
MG;PRESIDENTE OLEGARIO;4196;316;899;2295;139;18;836;8699
MG;PRUDENTE DE MORAIS;2601;147;265;647;17;5;353;4035
MG;QUARTEL GERAL;719;54;99;232;11;2;120;1237
MG;QUELUZITA;377;23;92;276;7;5;52;832
MG;RAPOSOS;3975;98;381;2219;33;42;415;7163
MG;RAUL SOARES;4466;316;785;5055;91;24;809;11546
MG;RECREIO;2149;202;297;791;30;7;313;3789
MG;REDUTO;1219;104;221;830;15;4;173;2566
MG;RESENDE COSTA;3639;254;775;1875;40;14;370;6967
MG;RESPLENDOR;2944;208;663;2919;58;19;944;7755
MG;RESSAQUINHA;1219;187;250;610;32;3;245;2546
MG;RIACHINHO;945;107;197;967;29;3;209;2457
MG;RIACHO DOS MACHADOS;879;69;193;1615;46;2;152;2956
MG;RIBEIRAO DAS NEVES;70213;2859;6407;25007;713;165;7504;112868
MG;RIBEIRAO VERMELHO;830;42;100;244;5;4;144;1369
MG;RIO ACIMA;2767;140;400;1065;19;57;412;4860
MG;RIO CASCA;2767;221;451;1176;52;23;428;5118
MG;RIO DO PRADO;313;16;83;453;17;0;88;970
MG;RIO DOCE;547;26;69;333;11;2;59;1047
MG;RIO ESPERA;794;51;146;1467;16;5;67;2546
MG;RIO MANSO;1309;203;316;925;15;7;138;2913
MG;RIO NOVO;2458;223;304;641;45;24;356;4051
MG;RIO PARANAIBA;4071;374;1143;1866;180;30;594;8258
MG;RIO PARDO DE MINAS;3247;264;860;6122;229;17;733;11472
MG;RIO PIRACICABA;3671;221;537;1001;35;37;430;5932
MG;RIO POMBA;5346;304;743;2571;52;73;856;9945
MG;RIO PRETO;3580;553;560;1443;60;42;770;7008
MG;RIO VERMELHO;1427;90;422;1877;51;7;263;4137
MG;RITAPOLIS;1005;40;150;564;13;3;122;1897
MG;ROCHEDO DE MINAS;505;31;46;233;4;1;48;868
MG;RODEIRO;1836;310;309;1230;32;32;454;4203
MG;ROMARIA;915;57;155;251;15;5;172;1570
MG;ROSARIO DA LIMEIRA;1020;90;177;1104;44;0;127;2562
MG;RUBELITA;327;22;88;533;16;2;42;1030
MG;RUBIM;701;27;210;1058;37;2;91;2126
MG;SABARA;28993;908;2911;12674;417;262;4885;51050
MG;SABINOPOLIS;2299;185;533;2784;79;16;264;6160
MG;SACRAMENTO;9101;610;1852;2448;114;137;1982;16244
MG;SALINAS;6295;521;1591;8493;190;86;1627;18803
MG;SALTO DA DIVISA;246;19;59;224;17;2;56;623
MG;SANTA BARBARA;8808;442;1306;2467;108;93;1100;14324
MG;SANTA BARBARA DO LESTE;1845;217;470;1567;16;7;218;4340
MG;SANTA BARBARA DO MONTE VERDE;1882;606;344;500;139;5;597;4073
MG;SANTA BARBARA DO TUGURIO;965;90;170;536;47;4;216;2028
MG;SANTA CRUZ DE MINAS;1777;93;240;1262;11;15;439;3837
MG;SANTA CRUZ DE SALINAS;292;33;98;627;33;2;36;1121
MG;SANTA CRUZ DO ESCALVADO;855;47;129;737;24;1;121;1914
MG;SANTA EFIGENIA DE MINAS;516;37;130;932;10;1;147;1773
MG;SANTA FE DE MINAS;159;10;45;218;10;2;19;463
MG;SANTA HELENA DE MINAS;413;14;88;584;15;0;42;1156
MG;SANTA JULIANA;4018;550;1118;847;100;45;1105;7783
MG;SANTA LUZIA;54141;2060;5370;20102;827;275;7168;89943
MG;SANTA MARGARIDA;4360;307;958;2498;64;18;449;8654
MG;SANTA MARIA DE ITABIRA;2085;158;348;1518;62;18;207;4396
MG;SANTA MARIA DO SALTO;307;10;95;409;13;1;86;921
MG;SANTA MARIA DO SUACUI;1810;109;419;1842;68;11;206;4465
MG;SANTA RITA DE CALDAS;3280;362;681;1543;26;15;360;6267
MG;SANTA RITA DE IBITIPOCA;601;62;95;342;9;2;59;1170
MG;SANTA RITA DE JACUTINGA;1504;124;250;632;9;8;211;2738
MG;SANTA RITA DE MINAS;1200;136;240;859;26;4;175;2640
MG;SANTA RITA DO ITUETO;919;130;338;1583;21;3;152;3146
MG;SANTA RITA DO SAPUCAI;12575;477;1808;4545;107;188;1856;21556
MG;SANTA ROSA DA SERRA;940;80;244;453;23;4;117;1861
MG;SANTA VITORIA;5327;497;1172;2409;77;28;2023;11533
MG;SANTANA DA VARGEM;2074;146;409;533;31;9;238;3440
MG;SANTANA DE CATAGUASES;659;39;89;611;8;2;105;1513
MG;SANTANA DE PIRAPAMA;1070;96;348;799;36;1;101;2451
MG;SANTANA DO DESERTO;1042;79;113;271;15;12;210;1742
MG;SANTANA DO GARAMBEU;391;24;81;232;11;3;48;790
MG;SANTANA DO JACARE;1085;68;185;256;21;2;123;1740
MG;SANTANA DO MANHUACU;1548;304;420;1852;26;3;124;4277
MG;SANTANA DO PARAISO;5276;267;568;2562;49;27;811;9560
MG;SANTANA DO RIACHO;720;63;248;455;11;18;116;1631
MG;SANTANA DOS MONTES;585;49;82;533;11;4;40;1304
MG;SANTO ANTONIO DO AMPARO;4253;380;648;1071;116;12;569;7049
MG;SANTO ANTONIO DO AVENTUREIRO;828;76;168;614;11;3;140;1840
MG;SANTO ANTONIO DO GRAMA;766;60;113;421;12;2;97;1471
MG;SANTO ANTONIO DO ITAMBE;502;20;78;563;18;0;34;1215
MG;SANTO ANTONIO DO JACINTO;808;54;229;1979;46;3;93;3212
MG;SANTO ANTONIO DO MONTE;10913;592;1982;2810;120;86;1720;18223
MG;SANTO ANTONIO DO RETIRO;576;77;203;1017;52;0;99;2024
MG;SANTO ANTONIO DO RIO ABAIXO;203;16;47;307;12;1;22;608
MG;SANTO HIPOLITO;311;29;59;361;7;1;45;813
MG;SANTOS DUMONT;10939;479;1175;4937;166;94;1594;19384
MG;SAO BENTO ABADE;1067;49;150;232;32;3;120;1653
MG;SAO BRAS DO SUACUI;1209;58;198;344;13;11;171;2004
MG;SAO DOMINGOS DAS DORES;1149;155;273;1469;20;6;138;3210
MG;SAO DOMINGOS DO PRATA;4272;371;701;1870;92;18;295;7619
MG;SAO FELIX DE MINAS;397;30;83;617;17;4;102;1250
MG;SAO FRANCISCO;4968;349;1054;8428;234;25;1742;16800
MG;SAO FRANCISCO DE PAULA;1725;94;263;896;26;7;207;3218
MG;SAO FRANCISCO DE SALES;1517;96;327;575;29;7;366;2917
MG;SAO FRANCISCO DO GLORIA;1008;76;177;595;10;2;93;1961
MG;SAO GERALDO;1800;193;252;1241;23;17;316;3842
MG;SAO GERALDO DA PIEDADE;349;31;85;897;15;3;83;1463
MG;SAO GERALDO DO BAIXIO;346;21;63;354;12;0;39;835
MG;SAO GONCALO DO ABAETE;1300;114;271;356;26;2;362;2431
MG;SAO GONCALO DO PARA;3398;314;664;1796;45;25;750;6992
MG;SAO GONCALO DO RIO ABAIXO;2873;234;419;770;47;15;466;4824
MG;SAO GONCALO DO RIO PRETO;511;35;117;403;9;4;62;1141
MG;SAO GONCALO DO SAPUCAI;7264;525;1142;1815;93;51;1100;11990
MG;SAO GOTARDO;12777;1118;3154;4357;309;157;2138;24010
MG;SAO JOAO BATISTA DO GLORIA;2045;167;410;1482;22;30;202;4358
MG;SAO JOAO DA LAGOA;444;49;137;383;16;2;78;1109
MG;SAO JOAO DA MATA;973;65;185;468;5;4;104;1804
MG;SAO JOAO DA PONTE;2151;88;377;3316;79;9;291;6311
MG;SAO JOAO DAS MISSOES;416;46;164;1321;31;1;59;2038
MG;SAO JOAO DEL REI;28129;1292;3506;15069;243;402;5871;54512
MG;SAO JOAO DO MANHUACU;2679;200;543;1651;51;15;294;5433
MG;SAO JOAO DO MANTENINHA;777;93;147;1112;10;4;256;2399
MG;SAO JOAO DO ORIENTE;1343;128;250;1153;15;6;186;3081
MG;SAO JOAO DO PACUI;296;23;56;416;12;0;46;849
MG;SAO JOAO DO PARAISO;3002;252;660;4445;133;13;809;9314
MG;SAO JOAO EVANGELISTA;3371;150;651;2578;50;12;382;7194
MG;SAO JOAO NEPOMUCENO;7322;311;919;3753;29;79;934;13347
MG;SAO JOAQUIM DE BICAS;7580;636;982;1817;69;38;1953;13075
MG;SAO JOSE DA BARRA;2039;130;367;585;36;45;292;3494
MG;SAO JOSE DA LAPA;8674;1250;1443;2916;482;111;1807;16683
MG;SAO JOSE DA SAFIRA;210;9;64;556;9;1;38;887
MG;SAO JOSE DA VARGINHA;744;67;136;858;20;2;116;1943
MG;SAO JOSE DO ALEGRE;966;49;153;418;8;4;103;1701
MG;SAO JOSE DO DIVINO;363;20;91;648;17;1;62;1202
MG;SAO JOSE DO GOIABAL;997;73;128;603;41;3;170;2015
MG;SAO JOSE DO JACURI;805;51;143;1079;9;2;116;2205
MG;SAO JOSE DO MANTIMENTO;421;44;75;659;5;0;51;1255
MG;SAO LOURENCO;14208;612;1878;7269;65;311;2587;26930
MG;SAO MIGUEL DO ANTA;1283;96;239;1384;15;3;126;3146
MG;SAO PEDRO DA UNIAO;1635;143;385;1130;22;6;150;3471
MG;SAO PEDRO DO SUACUI;673;48;116;660;12;5;82;1596
MG;SAO PEDRO DOS FERROS;1398;106;174;722;45;3;142;2590
MG;SAO ROMAO;849;56;250;909;20;9;261;2354
MG;SAO ROQUE DE MINAS;2177;238;859;1351;38;100;221;4984
MG;SAO SEBASTIAO DA BELA VISTA;1230;138;199;460;19;4;220;2270
MG;SAO SEBASTIAO DA VARGEM ALEGRE;666;50;118;567;10;0;89;1500
MG;SAO SEBASTIAO DO ANTA;1039;82;295;1287;11;2;111;2827
MG;SAO SEBASTIAO DO MARANHAO;822;33;150;1533;31;1;175;2745
MG;SAO SEBASTIAO DO OESTE;1422;192;252;796;65;8;210;2945
MG;SAO SEBASTIAO DO PARAISO;27832;1733;4042;8467;261;321;5825;48481
MG;SAO SEBASTIAO DO RIO PRETO;182;10;40;224;6;2;19;483
MG;SAO SEBASTIAO DO RIO VERDE;498;24;85;242;10;2;45;906
MG;SAO TIAGO;3389;308;610;1079;37;7;341;5771
MG;SAO TOMAS DE AQUINO;2341;121;416;424;18;11;217;3548
MG;SAO TOME DAS LETRAS;932;104;197;528;41;14;109;1925
MG;SAO VICENTE DE MINAS;1773;144;332;407;12;21;211;2900
MG;SAPUCAI-MIRIM;2197;240;331;816;13;14;293;3904
MG;SARDOA;1052;75;225;1580;17;3;192;3144
MG;SARZEDO;9283;984;1321;2130;129;65;1369;15281
MG;SEM-PEIXE;376;20;56;414;15;1;22;904
MG;SENADOR AMARAL;1553;147;594;917;20;4;133;3368
MG;SENADOR CORTES;488;33;72;186;5;2;47;833
MG;SENADOR FIRMINO;2194;140;365;2583;40;13;278;5613
MG;SENADOR JOSE BENTO;382;15;71;94;9;1;24;596
MG;SENADOR MODESTINO GONCALVES;498;36;142;502;15;1;42;1236
MG;SENHORA DE OLIVEIRA;1120;100;196;859;13;7;97;2392
MG;SENHORA DO PORTO;470;33;94;536;16;0;47;1196
MG;SENHORA DOS REMEDIOS;2055;163;291;2124;32;18;322;5005
MG;SERICITA;1620;111;489;1622;11;10;138;4001
MG;SERITINGA;509;30;79;122;4;4;56;804
MG;SERRA AZUL DE MINAS;340;21;102;562;13;0;63;1101
MG;SERRA DA SAUDADE;257;10;83;31;2;1;21;405
MG;SERRA DO SALITRE;3364;320;702;851;122;15;517;5891
MG;SERRA DOS AIMORES;850;91;130;703;37;3;234;2048
MG;SERRANIA;2058;136;287;570;28;8;270;3357
MG;SERRANOPOLIS DE MINAS;300;26;89;875;28;1;49;1368
MG;SERRANOS;510;31;83;185;5;1;49;864
MG;SERRO;3534;225;754;2407;90;31;322;7363
MG;SETE LAGOAS;72645;3842;11829;28149;824;725;15640;133654
MG;SETUBINHA;512;44;133;802;46;2;64;1603
MG;SILVEIRANIA;474;30;82;349;9;4;65;1013
MG;SILVIANOPOLIS;1642;105;333;660;20;8;188;2956
MG;SIMAO PEREIRA;1406;73;210;249;10;40;201;2189
MG;SIMONESIA;4027;371;1132;4552;57;25;331;10495
MG;SOBRALIA;917;41;144;787;11;2;80;1982
MG;SOLEDADE DE MINAS;1139;61;150;808;5;16;178;2357
MG;TABULEIRO;995;78;162;454;15;2;139;1845
MG;TAIOBEIRAS;7023;948;2296;9692;257;111;2131;22458
MG;TAPARUBA;494;32;81;444;13;0;109;1173
MG;TAPIRA;1134;163;339;372;33;11;174;2226
MG;TAPIRAI;346;21;95;146;10;0;38;656
MG;TAQUARACU DE MINAS;719;119;181;345;20;4;93;1481
MG;TARUMIRIM;2223;166;468;2040;37;12;314;5260
MG;TEIXEIRAS;3131;189;549;2617;19;16;444;6965
MG;TEOFILO OTONI;25964;1661;5572;21697;220;403;6792;62309
MG;TIMOTEO;25139;936;2614;11484;156;273;3786;44388
MG;TIRADENTES;2454;135;499;1283;13;77;580;5041
MG;TIROS;2355;223;780;834;21;23;296;4532
MG;TOCANTINS;4095;292;619;3508;30;34;873;9451
MG;TOCOS DO MOJI;1093;64;354;663;15;4;86;2279
MG;TOLEDO;1655;172;414;855;27;11;157;3291
MG;TOMBOS;2280;155;346;1564;46;14;305;4710
MG;TRES CORACOES;21062;1188;2940;5935;237;228;2701;34291
MG;TRES MARIAS;8536;450;1503;3197;144;39;2114;15983
MG;TRES PONTAS;17405;1122;2671;5016;242;256;2648;29360
MG;TUMIRITINGA;546;40;70;494;13;2;78;1243
MG;TUPACIGUARA;8182;706;1819;2719;105;57;3468;17056
MG;TURMALINA;3503;417;1009;5405;106;33;857;11330
MG;TURVOLANDIA;1410;147;251;692;16;2;151;2669
MG;UBA;30670;2125;4010;22293;210;316;8855;68479
MG;UBAI;823;55;177;1283;57;1;130;2526
MG;UBAPORANGA;2180;222;542;1877;42;9;296;5168
MG;UBERABA;125603;5458;16628;47866;1130;1976;31655;230316
MG;UBERLANDIA;254290;12250;35516;100150;1733;4144;67789;475872
MG;UMBURATIBA;158;13;47;253;8;1;40;520
MG;UNAI;24089;1873;5807;11849;577;253;10676;55124
MG;UNIAO DE MINAS;805;63;193;482;43;2;196;1784
MG;URUANA DE MINAS;385;28;63;292;19;0;56;843
MG;URUCANIA;2041;219;324;955;71;8;264;3882
MG;URUCUIA;894;106;169;1037;52;3;239;2500
MG;VARGEM ALEGRE;817;90;182;1071;21;9;100;2290
MG;VARGEM BONITA;445;46;135;222;11;18;38;915
MG;VARGEM GRANDE DO RIO PARDO;469;69;107;1048;23;1;75;1792
MG;VARGINHA;48829;2342;7019;17111;320;673;8325;84619
MG;VARJAO DE MINAS;1725;107;317;449;68;8;402;3076
MG;VARZEA DA PALMA;5465;544;1254;4893;129;39;2153;14477
MG;VARZELANDIA;1872;75;408;3921;72;5;360;6713
MG;VAZANTE;7601;409;1637;1759;83;42;1269;12800
MG;VERDELANDIA;449;20;114;922;15;1;82;1603
MG;VEREDINHA;799;81;228;1182;26;3;121;2440
MG;VERISSIMO;482;39;123;122;10;4;88;868
MG;VERMELHO NOVO;968;128;228;1353;33;0;88;2798
MG;VESPASIANO;27531;1424;3225;9676;313;175;4148;46492
MG;VICOSA;22645;812;3462;16342;238;452;3623;47574
MG;VIEIRAS;851;48;153;828;10;1;73;1964
MG;VIRGEM DA LAPA;1289;78;401;1850;38;1;163;3820
MG;VIRGINIA;1704;216;442;1224;18;17;272;3893
MG;VIRGINOPOLIS;2217;151;517;1863;40;10;325;5123
MG;VIRGOLANDIA;431;27;115;831;16;3;62;1485
MG;VISCONDE DO RIO BRANCO;10408;1220;1411;8799;96;111;3467;25512
MG;VOLTA GRANDE;954;83;122;348;13;4;173;1697
MG;WENCESLAU BRAZ;552;43;78;221;12;3;47;956
MS;AGUA CLARA;3644;460;1124;1877;128;58;1252;8543
MS;ALCINOPOLIS;891;134;570;908;24;30;313;2870
MS;AMAMBAI;8819;889;2668;4203;94;211;3751;20635
MS;ANASTACIO;4606;512;1252;4653;51;39;1867;12980
MS;ANAURILANDIA;1953;142;534;635;72;24;387;3747
MS;ANGELICA;2959;325;849;1450;85;18;1367;7053
MS;ANTONIO JOAO;1792;152;634;661;33;23;335;3630
MS;APARECIDA DO TABOADO;7236;510;1502;3657;79;83;2879;15946
MS;AQUIDAUANA;7932;447;2006;7297;94;93;2934;20803
MS;ARAL MOREIRA;1325;254;558;458;37;30;373;3035
MS;BANDEIRANTES;1741;247;579;788;56;15;432;3858
MS;BATAGUASSU;7193;522;1473;2131;251;83;1767;13420
MS;BATAYPORA;2710;211;627;1457;42;17;889;5953
MS;BELA VISTA;3817;364;1111;2160;85;75;904;8516
MS;BODOQUENA;1626;118;480;1280;47;17;385;3953
MS;BONITO;4847;385;1705;3525;96;129;1965;12652
MS;BRASILANDIA;3226;307;980;1443;111;47;1056;7170
MS;CAARAPO;6616;721;1804;2566;210;107;3088;15112
MS;CAMAPUA;3270;424;1368;1964;52;48;1142;8268
MS;CAMPO GRANDE;311814;16255;53810;143755;2266;7226;77934;613060
MS;CARACOL;869;85;298;534;20;7;159;1972
MS;CASSILANDIA;6533;524;1939;4735;63;71;2566;16431
MS;CHAPADAO DO SUL;8148;1045;2941;3645;139;295;4674;20887
MS;CORGUINHO;788;71;246;496;32;2;159;1794
MS;CORONEL SAPUCAIA;1750;384;606;556;41;41;400;3778
MS;CORUMBA;20633;1059;3496;11415;282;244;5838;42967
MS;COSTA RICA;6173;600;2090;3517;180;105;2550;15215
MS;COXIM;7309;721;2419;7117;98;134;4070;21868
MS;DEODAPOLIS;3711;324;893;1953;119;28;932;7960
MS;DOIS IRMAOS DO BURITI;1749;187;431;1263;40;5;352;4027
MS;DOURADINA;1633;318;476;930;31;6;838;4232
MS;DOURADOS;73458;4647;16075;34527;524;1576;30684;161491
MS;ELDORADO;3029;287;710;1248;46;55;1286;6661
MS;FATIMA DO SUL;6103;510;1440;3043;50;65;2499;13710
MS;FIGUEIRAO;478;66;273;349;9;6;126;1307
MS;GLORIA DE DOURADOS;3235;224;762;1496;34;25;863;6639
MS;GUIA LOPES DA LAGUNA;2304;229;685;1741;33;15;732;5739
MS;IGUATEMI;3427;310;806;1718;86;34;1117;7498
MS;INOCENCIA;2327;237;797;1067;52;29;528;5037
MS;ITAPORA;4564;530;1424;2325;53;59;2208;11163
MS;ITAQUIRAI;4104;301;769;2339;136;34;971;8654
MS;IVINHEMA;7678;791;2020;3808;303;128;3866;18594
MS;JAPORA;761;56;219;517;29;6;139;1727
MS;JARAGUARI;1009;106;363;434;21;7;173;2113
MS;JARDIM;6001;577;1762;3619;77;87;2310;14433
MS;JATEI;967;68;262;516;50;13;182;2058
MS;JUTI;1468;120;404;663;37;18;300;3010
MS;LADARIO;4526;194;528;2060;69;25;1029;8431
MS;LAGUNA CARAPA;1360;247;599;591;37;26;501;3361
MS;MARACAJU;10051;1313;3963;3850;179;308;6169;25833
MS;MIRANDA;4155;415;1201;3100;141;49;1306;10367
MS;MUNDO NOVO;5052;338;1001;1771;33;95;2295;10585
MS;NAVIRAI;14315;1129;3015;7716;203;268;6489;33135
MS;NIOAQUE;2777;231;703;2037;74;19;492;6333
MS;NOVA ALVORADA DO SUL;4928;445;1085;1871;85;58;1833;10305
MS;NOVA ANDRADINA;15293;1215;3464;7657;300;185;6350;34464
MS;NOVO HORIZONTE DO SUL;1348;95;312;1019;27;2;352;3155
MS;PARAISO DAS AGUAS;819;110;385;220;27;19;337;1917
MS;PARANAIBA;12733;940;3427;8794;131;124;5994;32143
MS;PARANHOS;1153;126;381;442;41;18;277;2438
MS;PEDRO GOMES;1316;136;589;1325;21;17;524;3928
MS;PONTA PORA;23698;2306;6114;5968;396;643;6015;45140
MS;PORTO MURTINHO;1155;99;345;1106;34;10;377;3126
MS;RIBAS DO RIO PARDO;3874;683;1389;2537;108;60;1710;10361
MS;RIO BRILHANTE;7950;785;2068;3241;163;122;4359;18688
MS;RIO NEGRO;1126;104;405;872;11;7;264;2789
MS;RIO VERDE DE MATO GROSSO;4207;447;1432;2984;43;62;1845;11020
MS;ROCHEDO;1035;82;329;489;15;15;184;2149
MS;SANTA RITA DO PARDO;1574;169;539;746;50;25;257;3360
MS;SAO GABRIEL DO OESTE;7830;1147;2755;3523;117;204;5196;20772
MS;SELVIRIA;2463;125;444;676;37;17;550;4312
MS;SETE QUEDAS;1869;291;577;1282;28;32;721;4800
MS;SIDROLANDIA;8797;801;2291;4464;351;103;3334;20141
MS;SONORA;2857;290;884;2788;120;29;1957;8925
MS;TACURU;1312;144;314;662;29;11;272;2744
MS;TAQUARUSSU;836;68;235;402;21;8;236;1806
MS;TERENOS;2932;408;848;1743;77;26;815;6849
MS;TRES LAGOAS;39757;2146;7705;21750;429;649;17590;90026
MS;VICENTINA;1767;177;472;1104;117;18;562;4217
MT;ACORIZAL;522;28;154;466;3;6;142;1321
MT;AGUA BOA;4860;769;2345;5201;63;94;4320;17652
MT;ALTA FLORESTA;12210;1614;5318;17052;164;265;10334;46957
MT;ALTO ARAGUAIA;3139;273;1165;2025;43;38;1359;8042
MT;ALTO BOA VISTA;465;78;312;1123;8;5;423;2414
MT;ALTO GARCAS;2213;332;936;1367;65;45;1712;6670
MT;ALTO PARAGUAI;694;51;207;907;8;4;365;2236
MT;ALTO TAQUARI;1801;298;659;844;32;36;930;4600
MT;APIACAS;650;176;496;1989;14;20;988;4333
MT;ARAGUAIANA;248;27;99;254;6;3;151;788
MT;ARAGUAINHA;67;12;38;40;1;0;25;183
MT;ARAPUTANGA;3270;315;915;4082;35;34;1964;10615
MT;ARENAPOLIS;2133;260;700;2100;73;32;1473;6771
MT;ARIPUANA;1637;532;1435;5360;67;58;1905;10994
MT;BARAO DE MELGACO;267;28;141;332;7;3;134;912
MT;BARRA DO BUGRES;4900;679;1629;5758;184;83;4129;17362
MT;BARRA DO GARCAS;14937;1090;4031;15950;270;284;10786;47348
MT;BOM JESUS DO ARAGUAIA;725;116;374;1269;25;4;412;2925
MT;BRASNORTE;2049;439;1141;2706;74;42;1558;8009
MT;CACERES;16155;1198;4255;19375;401;249;10304;51937
MT;CAMPINAPOLIS;1086;165;687;2349;29;11;532;4859
MT;CAMPO NOVO DO PARECIS;8048;1053;3223;5135;220;217;6569;24465
MT;CAMPO VERDE;9472;1182;3588;6249;190;203;7171;28055
MT;CAMPOS DE JULIO;1155;411;509;754;53;55;1230;4167
MT;CANABRAVA DO NORTE;423;57;181;1020;12;2;254;1949
MT;CANARANA;3904;700;2197;3686;47;148;3273;13955
MT;CARLINDA;1532;187;564;2289;30;13;790;5405
MT;CASTANHEIRA;874;196;637;2677;38;18;449;4889
MT;CHAPADA DOS GUIMARAES;3493;268;1253;2338;63;90;1134;8639
MT;CLAUDIA;1759;476;932;2338;34;47;1786;7372
MT;COCALINHO;259;73;123;363;11;1;189;1019
MT;COLIDER;7175;985;2872;7357;148;143;6053;24733
MT;COLNIZA;1626;546;1215;7635;36;59;1373;12490
MT;COMODORO;3006;747;1208;3451;111;48;2059;10630
MT;CONFRESA;3492;452;1673;5629;78;57;2551;13932
MT;CONQUISTA D'OESTE;513;78;203;792;16;6;288;1896
MT;COTRIGUACU;883;193;597;2845;45;20;537;5120
MT;CUIABA;215781;10975;42520;97358;3331;5799;60436;436200
MT;CURVELANDIA;762;128;277;1039;24;2;416;2648
MT;DENISE;1319;106;338;955;37;6;731;3492
MT;DIAMANTINO;4225;672;1682;4270;110;81;3771;14811
MT;DOM AQUINO;1308;143;484;1522;34;17;587;4095
MT;FELIZ NATAL;1368;327;669;1535;29;28;1400;5356
MT;FIGUEIROPOLIS D'OESTE;603;79;245;1157;11;5;244;2344
MT;GAUCHA DO NORTE;699;190;689;967;33;27;717;3322
MT;GENERAL CARNEIRO;273;35;134;256;10;2;196;906
MT;GLORIA D'OESTE;629;79;194;606;19;3;214;1744
MT;GUARANTA DO NORTE;5947;1086;3286;8852;111;117;4741;24140
MT;GUIRATINGA;2157;227;989;1797;19;26;1102;6317
MT;INDIAVAI;274;29;97;410;8;1;107;926
MT;IPIRANGA DO NORTE;1174;210;634;821;19;34;987;3879
MT;ITANHANGA;970;228;505;1006;17;30;651;3407
MT;ITAUBA;903;148;351;826;17;18;741;3004
MT;ITIQUIRA;1495;205;664;1334;87;26;909;4720
MT;JACIARA;6975;735;2012;5525;171;113;8153;23684
MT;JANGADA;1106;81;350;979;22;3;334;2875
MT;JAURU;1860;177;597;2971;48;12;556;6221
MT;JUARA;5334;1041;3132;9629;97;164;4293;23690
MT;JUINA;7076;1209;3565;13100;104;193;6688;31935
MT;JURUENA;988;234;570;2985;22;24;899;5722
MT;JUSCIMEIRA;1753;178;577;1468;79;14;927;4996
MT;LAMBARI D'OESTE;728;108;269;1068;35;5;360;2573
MT;LUCAS DO RIO VERDE;16307;2099;5956;11981;201;537;14768;51849
MT;LUCIARA;105;14;73;362;3;2;80;639
MT;MARCELANDIA;1777;476;967;2911;29;28;1609;7797
MT;MATUPA;3513;508;1764;3441;59;81;2836;12202
MT;MIRASSOL D'OESTE;6286;989;2279;6126;109;84;4258;20131
MT;NOBRES;2875;380;916;3241;60;31;2106;9609
MT;NORTELANDIA;1073;93;327;1165;26;7;555;3246
MT;NOSSA SENHORA DO LIVRAMENTO;1303;161;511;1188;41;4;312;3520
MT;NOVA BANDEIRANTES;1041;273;736;3206;45;9;820;6130
MT;NOVA BRASILANDIA;659;97;354;788;14;2;188;2102
MT;NOVA CANAA DO NORTE;2103;293;1044;3497;69;28;1234;8268
MT;NOVA GUARITA;898;135;460;1319;20;12;584;3428
MT;NOVA LACERDA;754;192;295;1013;38;8;405;2705
MT;NOVA MARILANDIA;449;56;193;503;8;6;246;1461
MT;NOVA MARINGA;588;142;371;790;16;13;649;2569
MT;NOVA MONTE VERDE;935;228;618;2307;15;20;689;4812
MT;NOVA MUTUM;9838;1293;3938;7372;165;299;8425;31330
MT;NOVA NAZARE;157;13;70;234;8;3;76;561
MT;NOVA OLIMPIA;3013;458;656;2523;153;18;2185;9006
MT;NOVA SANTA HELENA;582;85;282;613;19;7;336;1924
MT;NOVA UBIRATA;1348;303;740;1175;43;23;1216;4848
MT;NOVA XAVANTINA;3610;545;1372;4885;48;49;3174;13683
MT;NOVO HORIZONTE DO NORTE;405;68;211;770;11;2;221;1688
MT;NOVO MUNDO;844;153;576;1532;26;9;574;3714
MT;NOVO SANTO ANTONIO;61;5;53;201;3;0;39;362
MT;NOVO SAO JOAQUIM;761;134;461;1574;22;9;529;3490
MT;PARANAITA;1824;294;1001;2455;80;23;1335;7012
MT;PARANATINGA;3079;607;1915;4282;98;56;2747;12784
MT;PEDRA PRETA;3307;398;1018;2895;64;30;2299;10011
MT;PEIXOTO DE AZEVEDO;3883;539;1917;6281;96;77;3078;15871
MT;PLANALTO DA SERRA;267;42;139;444;12;3;159;1066
MT;POCONE;3811;628;1518;5845;48;48;2192;14090
MT;PONTAL DO ARAGUAIA;715;41;220;1076;3;11;590;2656
MT;PONTE BRANCA;95;11;73;165;1;2;28;375
MT;PONTES E LACERDA;9024;1139;3294;11563;153;123;7402;32698
MT;PORTO ALEGRE DO NORTE;1010;138;435;1866;39;22;771;4281
MT;PORTO DOS GAUCHOS;846;183;486;1114;10;17;757;3413
MT;PORTO ESPERIDIAO;1243;174;558;1677;66;14;504;4236
MT;PORTO ESTRELA;349;42;148;380;12;2;123;1056
MT;POXOREO;2144;211;964;2223;47;38;967;6594
MT;PRIMAVERA DO LESTE;19253;2446;7497;13597;248;765;16871;60677
MT;QUERENCIA;2840;559;1843;2956;97;138;2690;11123
MT;RESERVA DO CABACAL;288;22;85;542;7;2;106;1052
MT;RIBEIRAO CASCALHEIRA;1187;182;677;2206;23;16;861;5152
MT;RIBEIRAOZINHO;273;31;123;335;9;5;139;915
MT;RIO BRANCO;854;96;316;1506;34;8;495;3309
MT;RONDOLANDIA;60;196;56;32;29;2;51;426
MT;RONDONOPOLIS;61910;4985;16952;53757;556;1492;45948;185600
MT;ROSARIO OESTE;2012;209;698;1907;55;17;931;5829
MT;SALTO DO CEU;547;69;244;1040;25;3;262;2190
MT;SANTA CARMEM;868;193;415;694;24;22;836;3052
MT;SANTA CRUZ DO XINGU;108;17;87;397;9;0;98;716
MT;SANTA RITA DO TRIVELATO;462;114;233;283;16;14;364;1486
MT;SANTA TEREZINHA;208;16;124;949;20;1;198;1516
MT;SANTO AFONSO;357;38;131;415;13;2;138;1094
MT;SANTO ANTONIO DO LESTE;418;76;223;400;26;4;262;1409
MT;SANTO ANTONIO DO LEVERGER;2094;166;624;1579;15;18;556;5052
MT;SAO FELIX DO ARAGUAIA;621;81;362;1640;40;19;853;3616
MT;SAO JOSE DO POVO;290;26;132;350;7;2;100;907
MT;SAO JOSE DO RIO CLARO;2759;410;1172;2943;61;53;1823;9221
MT;SAO JOSE DO XINGU;300;44;198;952;16;6;242;1758
MT;SAO JOSE DOS QUATRO MARCOS;4241;543;1266;3870;85;48;2386;12439
MT;SAO PEDRO DA CIPA;674;27;142;424;27;4;308;1606
MT;SAPEZAL;4741;760;1770;3716;148;183;5464;16782
MT;SERRA NOVA DOURADA;52;8;38;141;5;2;36;282
MT;SINOP;41904;4123;14258;32807;247;1368;30789;125496
MT;SORRISO;22493;2934;9582;16821;278;1104;22158;75370
MT;TABAPORA;1130;225;591;1943;32;29;948;4898
MT;TANGARA DA SERRA;24010;2332;7461;20077;267;695;16890;71732
MT;TAPURAH;2477;421;1203;1826;50;76;2139;8192
MT;TERRA NOVA DO NORTE;2360;332;1108;2591;47;21;1129;7588
MT;TESOURO;176;26;133;198;5;2;85;625
MT;TORIXOREU;716;62;348;862;6;4;308;2306
MT;UNIAO DO SUL;332;121;241;739;11;9;469;1922
MT;VALE DE SAO DOMINGOS;302;27;128;484;15;3;103;1062
MT;VARZEA GRANDE;76307;5553;14327;48119;713;700;28853;174572
MT;VERA;1749;316;780;1571;32;36;1649;6133
MT;VILA BELA DA SANTISSIMA TRINDA;1238;190;617;2382;58;13;863;5361
MT;VILA RICA;2089;425;1392;5775;48;49;1786;11564
PA;ABAETETUBA;5789;466;960;19249;309;85;8660;35518
PA;ABEL FIGUEIREDO;297;75;171;695;7;1;187;1433
PA;ACARA;703;109;305;3211;103;7;382;4820
PA;AFUA;1;1;0;3;0;1;9;15
PA;AGUA AZUL DO NORTE;447;115;312;1687;39;4;439;3043
PA;ALENQUER;998;215;686;7374;91;50;634;10048
PA;ALMEIRIM;1140;294;297;1467;104;18;733;4053
PA;ALTAMIRA;11399;1936;5449;33583;395;390;10283;63435
PA;ANAJAS;8;0;6;238;1;0;65;318
PA;ANANINDEUA;68054;4474;7799;47249;1681;865;15752;145874
PA;ANAPU;566;200;545;2840;26;15;448;4640
PA;AUGUSTO CORREA;813;90;298;1855;88;11;242;3397
PA;AURORA DO PARA;721;107;233;1464;85;1;176;2787
PA;AVEIRO;17;7;21;201;6;1;35;288
PA;BAGRE;14;2;10;142;2;1;28;199
PA;BAIAO;291;70;212;1352;28;2;339;2294
PA;BANNACH;96;28;108;471;6;7;80;796
PA;BARCARENA;9746;1159;1623;11527;855;142;5707;30759
PA;BELEM;238482;8908;29650;127200;3867;6187;54718;469012
PA;BELTERRA;702;72;254;1447;81;13;355;2924
PA;BENEVIDES;4587;1099;882;5805;181;89;2427;15070
PA;BOM JESUS DO TOCANTINS;571;83;307;1548;10;7;379;2905
PA;BONITO;542;68;141;743;106;5;126;1731
PA;BRAGANCA;5568;502;1636;12345;237;82;3335;23705
PA;BRASIL NOVO;679;208;633;4067;13;14;417;6031
PA;BREJO GRANDE DO ARAGUAIA;210;32;116;812;11;2;227;1410
PA;BREU BRANCO;1447;357;593;5022;132;22;1130;8703
PA;BREVES;869;65;198;5776;11;31;1356;8306
PA;BUJARU;459;49;166;1217;43;3;300;2237
PA;CACHOEIRA DO ARARI;105;19;49;784;20;1;86;1064
PA;CACHOEIRA DO PIRIA;393;54;200;861;33;3;151;1695
PA;CAMETA;1276;177;415;10629;90;37;1420;14044
PA;CANAA DOS CARAJAS;4834;483;1838;8818;244;95;3832;20144
PA;CAPANEMA;7597;862;1756;12901;125;123;5959;29323
PA;CAPITAO POCO;2287;517;885;3833;132;43;1159;8856
PA;CASTANHAL;23891;2982;5095;32772;481;398;14781;80400
PA;CHAVES;4;1;2;12;0;1;3;23
PA;COLARES;161;12;52;490;5;1;69;790
PA;CONCEICAO DO ARAGUAIA;3283;478;1398;9224;127;56;3585;18151
PA;CONCORDIA DO PARA;947;174;327;3343;84;7;574;5456
PA;CUMARU DO NORTE;97;35;131;721;10;3;105;1102
PA;CURIONOPOLIS;1353;310;650;3421;36;31;1406;7207
PA;CURRALINHO;19;4;8;356;2;0;52;441
PA;CURUA;20;11;45;585;5;7;25;698
PA;CURUCA;912;68;225;2143;29;3;390;3770
PA;DOM ELISEU;2165;627;1053;6156;58;46;2583;12688
PA;ELDORADO DOS CARAJAS;1157;229;663;4549;28;22;1278;7926
PA;FARO;15;4;9;80;1;2;23;134
PA;FLORESTA DO ARAGUAIA;584;248;533;2298;22;2;670;4357
PA;GARRAFAO DO NORTE;721;153;249;787;28;8;149;2095
PA;GOIANESIA DO PARA;942;325;582;3131;50;15;1356;6401
PA;GURUPA;30;14;19;574;3;0;69;709
PA;IGARAPE-ACU;1854;271;572;3300;147;35;1327;7506
PA;IGARAPE-MIRI;949;134;256;3754;53;16;1080;6242
PA;INHANGAPI;337;46;114;807;35;5;165;1509
PA;IPIXUNA DO PARA;805;119;259;1524;66;6;315;3094
PA;IRITUIA;745;115;302;1753;63;6;205;3189
PA;ITAITUBA;7669;1482;4383;23750;194;325;7302;45105
PA;ITUPIRANGA;1348;329;1007;5785;51;12;1790;10322
PA;JACAREACANGA;85;58;132;676;5;8;177;1141
PA;JACUNDA;1927;638;1292;9657;61;30;3078;16683
PA;JURUTI;363;111;276;1968;44;25;363;3150
PA;LIMOEIRO DO AJURU;17;3;7;303;5;2;21;358
PA;MAE DO RIO;2058;373;571;5163;89;18;1071;9343
PA;MAGALHAES BARATA;116;14;28;299;13;0;52;522
PA;MARABA;32361;3892;11239;50534;775;532;22288;121621
PA;MARACANA;346;31;120;968;41;3;197;1706
PA;MARAPANIM;682;38;121;1300;39;6;272;2458
PA;MARITUBA;9753;1182;1496;10682;553;128;4098;27892
PA;MEDICILANDIA;837;217;716;4414;47;19;339;6589
PA;MELGACO;13;7;7;163;4;0;23;217
PA;MOCAJUBA;292;24;117;1315;16;4;237;2005
PA;MOJU;1657;263;478;6106;279;14;1103;9900
PA;MOJUI DOS CAMPOS;390;71;252;809;61;10;142;1735
PA;MONTE ALEGRE;1467;365;1159;9469;236;67;1425;14188
PA;MUANA;47;6;23;626;12;1;110;825
PA;NOVA ESPERANCA DO PIRIA;409;106;254;599;29;4;147;1548
PA;NOVA IPIXUNA;548;172;331;1854;32;8;499;3444
PA;NOVA TIMBOTEUA;675;84;170;930;23;1;258;2141
PA;NOVO PROGRESSO;2197;991;2321;7503;55;91;2491;15649
PA;NOVO REPARTIMENTO;1602;566;1509;11935;81;26;1827;17546
PA;OBIDOS;968;232;792;4627;80;49;734;7482
PA;OEIRAS DO PARA;34;9;11;534;12;0;61;661
PA;ORIXIMINA;1940;362;976;6132;50;49;1074;10583
PA;OUREM;673;158;254;890;22;7;202;2206
PA;OURILANDIA DO NORTE;2067;357;1039;7586;31;53;2030;13163
PA;PACAJA;730;187;737;5483;17;12;814;7980
PA;PALESTINA DO PARA;121;26;71;534;5;0;122;879
PA;PARAGOMINAS;10362;1912;3556;17410;259;342;8876;42717
PA;PARAUAPEBAS;28721;2897;10325;34591;1409;597;21518;100058
PA;PAU D'ARCO;283;35;91;967;11;0;228;1615
PA;PEIXE-BOI;559;39;95;515;22;7;169;1406
PA;PICARRA;127;35;147;1103;8;2;185;1607
PA;PLACAS;235;124;281;2178;10;14;270;3112
PA;PONTA DE PEDRAS;105;22;29;854;5;1;255;1271
PA;PORTEL;141;25;55;1266;11;6;479;1983
PA;PORTO DE MOZ;114;27;67;681;7;2;279;1177
PA;PRAINHA;83;42;128;1056;8;4;115;1436
PA;PRIMAVERA;448;36;102;679;26;3;144;1438
PA;QUATIPURU;246;14;68;410;20;0;85;843
PA;REDENCAO;12534;2092;6052;30815;234;308;11860;63895
PA;RIO MARIA;1293;366;903;3808;59;32;1692;8153
PA;RONDON DO PARA;2305;560;1340;8203;31;52;3202;15693
PA;RUROPOLIS;589;294;578;3790;29;21;824;6125
PA;SALINOPOLIS;2552;274;556;4908;122;54;1526;9992
PA;SALVATERRA;388;62;130;1646;32;7;445;2710
PA;SANTA BARBARA DO PARA;1003;85;186;1536;113;13;505;3441
PA;SANTA CRUZ DO ARARI;7;5;11;155;1;0;5;184
PA;SANTA ISABEL DO PARA;5294;856;1171;8889;213;66;3669;20158
PA;SANTA LUZIA DO PARA;814;132;284;1394;41;7;325;2997
PA;SANTA MARIA DAS BARREIRAS;426;154;409;1338;51;9;323;2710
PA;SANTA MARIA DO PARA;1835;404;517;2698;81;30;1189;6754
PA;SANTANA DO ARAGUAIA;1913;403;1046;7116;57;24;2132;12691
PA;SANTAREM;35218;3405;10975;45715;939;1716;9579;107547
PA;SANTAREM NOVO;216;11;26;384;20;0;52;709
PA;SANTO ANTONIO DO TAUA;1298;172;338;2090;110;21;673;4702
PA;SAO CAETANO DE ODIVELAS;336;30;127;809;22;3;216;1543
PA;SAO DOMINGOS DO ARAGUAIA;1023;199;532;4776;32;12;1481;8055
PA;SAO DOMINGOS DO CAPIM;467;47;134;1289;37;2;105;2081
PA;SAO FELIX DO XINGU;1418;441;1242;12545;56;31;2572;18305
PA;SAO FRANCISCO DO PARA;755;78;229;1408;29;4;409;2912
PA;SAO GERALDO DO ARAGUAIA;845;152;590;5195;23;16;1535;8356
PA;SAO JOAO DA PONTA;117;5;33;239;9;0;44;447
PA;SAO JOAO DE PIRABAS;499;38;115;1087;33;3;178;1953
PA;SAO JOAO DO ARAGUAIA;344;44;133;981;13;2;206;1723
PA;SAO MIGUEL DO GUAMA;2338;515;662;6560;141;58;1504;11778
PA;SAO SEBASTIAO DA BOA VISTA;26;5;3;352;1;1;64;452
PA;SAPUCAIA;270;52;173;799;14;5;205;1518
PA;SENADOR JOSE PORFIRIO;99;48;100;751;12;1;128;1139
PA;SOURE;415;39;109;1946;16;14;626;3165
PA;TAILANDIA;2980;888;1251;13649;247;65;3955;23035
PA;TERRA ALTA;421;21;83;746;18;2;145;1436
PA;TERRA SANTA;67;35;49;590;3;1;193;938
PA;TOME-ACU;2494;607;1194;7809;183;43;2283;14613
PA;TRACUATEUA;615;55;185;1408;93;5;174;2535
PA;TRAIRAO;331;197;380;1945;18;11;418;3300
PA;TUCUMA;3065;771;2306;16461;103;79;3710;26495
PA;TUCURUI;7828;979;2368;15981;247;191;6036;33630
PA;ULIANOPOLIS;816;273;399;2439;60;27;956;4970
PA;URUARA;1225;590;1207;6957;42;90;1657;11768
PA;VIGIA;1764;156;465;3231;92;20;1795;7523
PA;VISEU;521;93;280;2060;60;1;274;3289
PA;VITORIA DO XINGU;578;70;309;1336;30;14;300;2637
PA;XINGUARA;4539;1253;2750;14738;145;135;5933;29493
PB;AGUA BRANCA;364;17;136;302;6;7;73;905
PB;AGUIAR;293;17;110;734;3;1;33;1191
PB;ALAGOA GRANDE;1888;133;284;3290;49;17;507;6168
PB;ALAGOA NOVA;1741;169;548;1890;12;22;287;4669
PB;ALAGOINHA;975;47;145;1607;43;10;284;3111
PB;ALCANTIL;313;68;80;261;17;1;80;820
PB;ALGODAO DE JANDAIRA;210;37;49;102;7;0;12;417
PB;ALHANDRA;1961;208;479;1781;56;11;1196;5692
PB;AMPARO;137;15;39;152;6;1;23;373
PB;APARECIDA;479;44;126;1108;19;2;273;2051
PB;ARACAGI;1153;95;274;2901;64;9;275;4771
PB;ARARA;842;100;170;731;20;6;239;2108
PB;ARARUNA;1211;102;244;2067;18;6;475;4123
PB;AREIA;2286;133;402;2509;30;27;529;5916
PB;AREIA DE BARAUNAS;96;7;23;161;2;0;13;302
PB;AREIAL;634;56;76;405;12;1;99;1283
PB;AROEIRAS;895;109;237;1252;24;1;245;2763
PB;ASSUNCAO;232;31;61;191;6;4;47;572
PB;BAIA DA TRAICAO;431;16;95;932;17;6;110;1607
PB;BANANEIRAS;2061;135;387;2353;36;32;352;5356
PB;BARAUNA;287;23;44;183;8;4;49;598
PB;BARRA DE SANTA ROSA;1000;91;197;759;23;7;242;2319
PB;BARRA DE SANTANA;490;103;102;525;20;1;72;1313
PB;BARRA DE SAO MIGUEL;220;18;81;209;6;2;19;555
PB;BAYEUX;13612;716;1411;11631;203;106;3094;30773
PB;BELEM;1559;150;233;1779;16;9;396;4142
PB;BELEM DO BREJO DO CRUZ;173;17;52;701;4;5;194;1146
PB;BERNARDINO BATISTA;120;8;40;277;5;0;12;462
PB;BOA VENTURA;266;16;46;744;4;3;72;1151
PB;BOA VISTA;793;103;128;687;24;1;174;1910
PB;BOM JESUS;190;11;20;293;3;0;49;566
PB;BOM SUCESSO;173;11;63;1007;9;1;81;1345
PB;BONITO DE SANTA FE;551;41;151;1404;4;3;190;2344
PB;BOQUEIRAO;1583;240;440;2026;27;13;458;4787
PB;BORBOREMA;366;40;67;476;3;0;41;993
PB;BREJO DO CRUZ;459;60;205;2098;10;8;946;3786
PB;BREJO DOS SANTOS;295;25;57;1108;4;1;128;1618
PB;CAAPORA;1495;69;200;1043;21;9;822;3659
PB;CABACEIRAS;549;39;130;413;19;1;58;1209
PB;CABEDELO;12798;507;1732;6357;46;694;3648;25782
PB;CACHOEIRA DOS INDIOS;542;20;118;1324;9;3;157;2173
PB;CACIMBA DE AREIA;182;5;41;422;5;2;28;685
PB;CACIMBA DE DENTRO;1002;87;118;1222;35;4;227;2695
PB;CACIMBAS;320;6;95;699;5;4;53;1182
PB;CAICARA;427;17;77;845;5;1;101;1473
PB;CAJAZEIRAS;10858;424;2454;14200;74;154;4734;32898
PB;CAJAZEIRINHAS;93;4;62;371;3;0;110;643
PB;CALDAS BRANDAO;504;43;52;868;9;2;127;1605
PB;CAMALAU;268;39;105;373;17;3;54;859
PB;CAMPINA GRANDE;89086;4256;12149;57842;878;2086;23200;189497
PB;CAPIM;512;34;61;501;22;5;87;1222
PB;CARAUBAS;139;15;69;139;4;4;22;392
PB;CARRAPATEIRA;105;6;44;385;3;0;25;568
PB;CASSERENGUE;515;48;84;265;18;1;98;1029
PB;CATINGUEIRA;188;20;57;352;2;2;68;689
PB;CATOLE DO ROCHA;3091;240;697;7157;17;51;2756;14009
PB;CATURITE;506;107;163;572;15;3;112;1478
PB;CONCEICAO;1143;109;363;2817;9;10;553;5004
PB;CONDADO;353;37;107;841;9;1;199;1547
PB;CONDE;2267;157;540;2944;27;39;575;6549
PB;CONGO;273;26;104;333;6;7;38;787
PB;COREMAS;808;80;418;3372;11;12;467;5168
PB;COXIXOLA;120;7;46;156;4;0;51;384
PB;CRUZ DO ESPIRITO SANTO;1251;35;164;2425;32;13;211;4131
PB;CUBATI;467;43;81;545;6;3;69;1214
PB;CUITE;1412;85;243;1475;20;20;353;3608
PB;CUITE DE MAMANGUAPE;449;22;81;743;42;1;93;1431
PB;CUITEGI;549;23;84;710;3;3;240;1612
PB;CURRAL DE CIMA;318;18;88;716;19;0;63;1222
PB;CURRAL VELHO;62;8;28;319;3;0;26;446
PB;DAMIAO;336;37;48;161;8;0;26;616
PB;DESTERRO;628;26;149;1006;6;16;270;2101
PB;DIAMANTE;305;19;69;915;5;1;89;1403
PB;DONA INES;632;53;107;951;24;3;115;1885
PB;DUAS ESTRADAS;268;13;51;418;5;1;85;841
PB;EMAS;150;10;28;257;5;1;21;472
PB;ESPERANCA;3871;557;634;3869;91;51;1118;10191
PB;FAGUNDES;716;47;159;1480;35;2;104;2543
PB;FREI MARTINHO;96;10;28;171;6;0;20;331
PB;GADO BRAVO;450;59;73;442;20;2;74;1120
PB;GUARABIRA;7634;576;1420;9066;246;123;4320;23385
PB;GURINHEM;912;63;138;1713;32;5;178;3041
PB;GURJAO;227;24;51;265;6;0;35;608
PB;IBIARA;303;10;82;897;5;0;110;1407
PB;IGARACY;343;19;76;1075;5;3;69;1590
PB;IMACULADA;333;16;113;579;6;2;151;1200
PB;INGA;1497;129;234;2766;40;7;802;5475
PB;ITABAIANA;2453;159;497;2979;41;29;1187;7345
PB;ITAPORANGA;2036;160;528;4680;28;37;969;8438
PB;ITAPOROROCA;1547;140;350;2860;39;13;585;5534
PB;ITATUBA;482;41;140;1208;16;5;129;2021
PB;JACARAU;1146;68;284;1826;24;12;220;3580
PB;JERICO;425;27;95;1426;3;6;164;2146
PB;JOAO PESSOA;217923;6382;25720;109064;2382;7467;35675;404613
PB;JUAREZ TAVORA;639;37;102;1010;15;1;111;1915
PB;JUAZEIRINHO;1365;86;204;1081;18;5;187;2946
PB;JUNCO DO SERIDO;508;58;115;331;6;5;66;1089
PB;JURIPIRANGA;649;58;118;428;23;11;157;1444
PB;JURU;316;19;104;682;5;9;81;1216
PB;LAGOA;191;19;49;646;6;1;73;985
PB;LAGOA DE DENTRO;638;55;156;1002;16;1;136;2004
PB;LAGOA SECA;2786;269;774;3570;20;75;743;8237
PB;LASTRO;129;9;61;522;4;0;37;762
PB;LIVRAMENTO;346;40;95;491;7;2;81;1062
PB;LOGRADOURO;179;5;21;337;10;3;47;602
PB;LUCENA;983;35;197;1559;26;12;276;3088
PB;MAE D'AGUA;161;5;49;348;4;3;23;593
PB;MALTA;293;12;82;749;4;2;224;1366
PB;MAMANGUAPE;5372;496;879;6806;104;64;1838;15559
PB;MANAIRA;205;29;78;592;6;4;73;987
PB;MARCACAO;486;6;124;627;17;4;77;1341
PB;MARI;1598;118;257;2847;60;15;653;5548
PB;MARIZOPOLIS;371;38;61;774;5;1;204;1454
PB;MASSARANDUBA;941;49;219;1558;13;5;208;2993
PB;MATARACA;580;50;95;890;19;3;123;1760
PB;MATINHAS;254;15;117;348;4;2;37;777
PB;MATO GROSSO;166;13;62;443;3;2;136;825
PB;MATUREIA;412;19;118;749;11;0;117;1426
PB;MOGEIRO;632;39;118;1827;10;1;293;2920
PB;MONTADAS;557;62;86;308;8;2;82;1105
PB;MONTE HOREBE;226;8;60;579;5;1;106;985
PB;MONTEIRO;3075;319;807;4031;69;60;1204;9565
PB;MULUNGU;550;65;83;1205;21;1;88;2013
PB;NATUBA;190;40;60;294;7;0;28;619
PB;NAZAREZINHO;355;29;129;809;5;4;125;1456
PB;NOVA FLORESTA;414;37;94;467;9;5;123;1149
PB;NOVA OLINDA;239;26;79;911;5;3;86;1349
PB;NOVA PALMEIRA;297;33;44;252;4;2;44;676
PB;OLHO D'AGUA;274;14;135;555;6;0;92;1076
PB;OLIVEDOS;403;45;65;256;12;1;28;810
PB;OURO VELHO;184;14;49;212;7;0;51;517
PB;PARARI;140;6;31;213;2;0;10;402
PB;PASSAGEM;190;19;52;286;3;0;42;592
PB;PATOS;15588;695;2867;21415;61;321;10228;51175
PB;PAULISTA;573;70;290;1850;14;9;576;3382
PB;PEDRA BRANCA;157;11;49;510;5;0;35;767
PB;PEDRA LAVRADA;494;48;95;489;12;1;61;1200
PB;PEDRAS DE FOGO;2395;326;597;1915;108;29;1490;6860
PB;PEDRO REGIS;257;21;73;611;5;1;33;1001
PB;PIANCO;1144;98;369;3246;8;19;572;5456
PB;PICUI;1236;129;261;1597;57;11;436;3727
PB;PILAR;819;36;103;1559;16;0;172;2705
PB;PILOES;459;37;92;809;13;2;141;1553
PB;PILOEZINHOS;309;11;49;832;6;2;121;1330
PB;PIRPIRITUBA;736;46;142;1185;14;7;312;2442
PB;PITIMBU;758;42;260;850;10;10;694;2624
PB;POCINHOS;1514;163;244;946;31;9;221;3128
PB;POCO DANTAS;123;10;36;498;5;0;20;692
PB;POCO DE JOSE DE MOURA;195;8;48;648;6;0;93;998
PB;POMBAL;2888;326;867;6491;24;62;2848;13506
PB;PRATA;188;29;64;256;6;4;62;609
PB;PRINCESA ISABEL;1261;143;391;1873;31;29;684;4412
PB;PUXINANA;1008;82;177;851;19;5;248;2390
PB;QUEIMADAS;5424;526;932;6027;100;27;1785;14821
PB;QUIXABA;122;9;24;245;4;1;33;438
PB;REMIGIO;2005;263;346;1830;37;18;422;4921
PB;RIACHAO;167;7;26;308;8;0;21;537
PB;RIACHAO DO BACAMARTE;412;29;49;529;5;1;137;1162
PB;RIACHAO DO POCO;383;31;103;715;18;1;73;1324
PB;RIACHO DE SANTO ANTONIO;155;18;29;83;3;1;21;310
PB;RIACHO DOS CAVALOS;369;32;169;1215;5;0;307;2097
PB;RIO TINTO;2734;113;334;2617;52;37;700;6587
PB;SALGADINHO;198;5;50;187;5;1;18;464
PB;SALGADO DE SAO FELIX;552;23;139;872;15;2;144;1747
PB;SANTA CECILIA;129;63;59;115;14;0;28;408
PB;SANTA CRUZ;306;19;78;726;18;0;74;1221
PB;SANTA HELENA;303;11;93;696;13;0;126;1242
PB;SANTA INES;123;13;44;534;3;1;19;737
PB;SANTA LUZIA;1630;147;386;2194;18;9;822;5206
PB;SANTA RITA;18437;980;1962;15963;299;131;3596;41368
PB;SANTA TERESINHA;257;24;71;828;5;1;121;1307
PB;SANTANA DE MANGUEIRA;150;3;56;759;3;0;28;999
PB;SANTANA DOS GARROTES;297;18;111;769;4;6;71;1276
PB;SANTAREM;139;7;37;298;4;0;45;530
PB;SANTO ANDRE;183;19;31;261;27;0;16;537
PB;SAO BENTINHO;198;19;67;430;4;1;144;863
PB;SAO BENTO;1739;216;950;7168;33;69;4573;14748
PB;SAO DOMINGOS DE POMBAL;111;8;33;425;6;0;62;645
PB;SAO DOMINGOS DO CARIRI;165;9;62;236;5;4;35;516
PB;SAO FRANCISCO;247;11;45;567;5;0;87;962
PB;SAO JOAO DO CARIRI;468;35;101;430;10;4;58;1106
PB;SAO JOAO DO RIO DO PEIXE;1125;70;321;2759;22;16;842;5155
PB;SAO JOAO DO TIGRE;108;16;53;212;5;1;9;404
PB;SAO JOSE DA LAGOA TAPADA;283;33;112;693;7;4;74;1206
PB;SAO JOSE DE CAIANA;238;11;92;872;8;1;46;1268
PB;SAO JOSE DE ESPINHARAS;161;18;51;427;6;2;49;714
PB;SAO JOSE DE PIRANHAS;1396;54;493;2952;13;18;892;5818
PB;SAO JOSE DE PRINCESA;45;6;27;170;3;1;44;296
PB;SAO JOSE DO BONFIM;173;11;47;585;4;0;88;908
PB;SAO JOSE DO BREJO DO CRUZ;47;3;23;144;2;0;24;243
PB;SAO JOSE DO SABUGI;243;24;75;288;8;0;57;695
PB;SAO JOSE DOS CORDEIROS;212;19;46;190;7;0;18;492
PB;SAO JOSE DOS RAMOS;303;25;65;711;13;2;79;1198
PB;SAO MAMEDE;580;33;144;899;7;4;196;1863
PB;SAO MIGUEL DE TAIPU;316;24;55;715;8;1;38;1157
PB;SAO SEBASTIAO DE LAGOA DE ROCA;1154;121;221;1284;16;4;172;2972
PB;SAO SEBASTIAO DO UMBUZEIRO;117;12;60;199;6;0;23;417
PB;SAO VICENTE DO SERIDO;646;39;67;570;14;1;60;1397
PB;SAPE;5040;419;824;8237;129;43;2149;16841
PB;SERRA BRANCA;1151;111;249;1118;11;2;193;2835
PB;SERRA DA RAIZ;191;9;23;220;7;0;33;483
PB;SERRA GRANDE;162;7;27;344;5;0;29;574
PB;SERRA REDONDA;548;30;78;979;5;0;127;1767
PB;SERRARIA;375;22;52;438;12;5;42;946
PB;SERTAOZINHO;402;12;70;655;17;1;96;1253
PB;SOBRADO;742;89;261;1445;8;0;181;2726
PB;SOLANEA;3180;256;603;3189;44;31;839;8142
PB;SOLEDADE;1496;187;270;1861;30;12;399;4255
PB;SOSSEGO;208;24;36;122;6;0;18;414
PB;SOUSA;8538;988;1763;14608;85;174;5470;31626
PB;SUME;1623;137;401;1695;24;9;323;4212
PB;TACIMA;456;38;75;617;18;1;68;1273
PB;TAPEROA;840;90;179;1098;12;10;197;2426
PB;TAVARES;364;28;105;813;12;4;92;1418
PB;TEIXEIRA;2002;106;457;3464;20;16;551;6616
PB;TENORIO;163;12;39;108;5;0;21;348
PB;TRIUNFO;546;26;143;1579;6;2;192;2494
PB;UIRAUNA;1176;79;342;3436;5;16;662;5716
PB;UMBUZEIRO;505;70;188;408;34;10;151;1366
PB;VARZEA;156;16;43;264;5;0;51;535
PB;VIEIROPOLIS;315;9;91;743;11;1;70;1240
PB;VISTA SERRANA;145;16;80;601;5;3;209;1059
PB;ZABELE;93;21;29;151;9;0;31;334
PE;ABREU E LIMA;15167;697;1267;9673;373;71;2960;30208
PE;AFOGADOS DA INGAZEIRA;6021;502;1438;9422;98;67;2233;19781
PE;AFRANIO;853;226;392;3500;26;4;320;5321
PE;AGRESTINA;2962;214;430;2601;36;16;885;7144
PE;AGUA PRETA;1837;172;173;2170;83;9;676;5120
PE;AGUAS BELAS;2250;389;628;5062;73;24;993;9419
PE;ALAGOINHA;1250;154;228;1084;20;0;260;2996
PE;ALIANCA;3326;178;323;2711;141;14;879;7572
PE;ALTINHO;1622;112;282;1868;40;12;639;4575
PE;AMARAJI;1281;135;261;1501;55;13;287;3533
PE;ANGELIM;874;55;207;727;10;4;178;2055
PE;ARACOIABA;1354;99;134;1255;97;0;407;3346
PE;ARARIPINA;7095;1085;1945;18551;89;66;3611;32442
PE;ARCOVERDE;13207;1242;2255;8192;147;180;3744;28967
PE;BARRA DE GUABIRABA;929;72;158;747;16;4;133;2059
PE;BARREIROS;3716;286;389;3553;83;24;1292;9343
PE;BELEM DE MARIA;827;93;128;749;19;3;213;2032
PE;BELEM DE SAO FRANCISCO;1350;119;361;2351;26;8;401;4616
PE;BELO JARDIM;9554;930;1880;12304;113;99;4541;29421
PE;BETANIA;610;53;155;1921;16;1;99;2855
PE;BEZERROS;8444;905;1400;9825;120;88;3323;24105
PE;BODOCO;1667;246;662;6361;29;8;286;9259
PE;BOM CONSELHO;3288;337;885;6929;49;28;1197;12713
PE;BOM JARDIM;4201;308;596;3774;78;17;980;9954
PE;BONITO;3520;421;704;3045;55;34;708;8487
PE;BREJAO;569;72;156;857;16;3;136;1809
PE;BREJINHO;480;61;136;878;8;0;102;1665
PE;BREJO DA MADRE DE DEUS;3090;452;1424;6962;23;26;1800;13777
PE;BUENOS AIRES;970;66;197;1166;24;5;181;2609
PE;BUIQUE;2855;292;808;4017;63;15;577;8627
PE;CABO DE SANTO AGOSTINHO;27854;1532;2621;14339;538;244;6970;54098
PE;CABROBO;2821;289;558;5692;30;12;729;10131
PE;CACHOEIRINHA;2294;233;496;2583;17;23;1082;6728
PE;CAETES;2137;324;421;1922;54;10;274;5142
PE;CALCADO;903;86;192;1373;29;0;294;2877
PE;CALUMBI;453;56;116;981;9;1;91;1707
PE;CAMARAGIBE;25086;794;2538;14235;163;211;4171;47198
PE;CAMOCIM DE SAO FELIX;1763;171;340;1267;15;16;337;3909
PE;CAMUTANGA;628;103;96;969;24;3;293;2116
PE;CANHOTINHO;2032;233;416;2398;31;14;489;5613
PE;CAPOEIRAS;1452;285;401;1582;28;6;232;3986
PE;CARNAIBA;1316;150;503;2814;29;12;358;5182
PE;CARNAUBEIRA DA PENHA;381;44;169;981;7;4;74;1660
PE;CARPINA;12068;1010;1880;11295;184;153;5101;31691
PE;CARUARU;72955;5073;10389;59437;789;1328;25215;175186
PE;CASINHAS;775;97;128;2069;23;1;313;3406
PE;CATENDE;2944;200;351;3359;85;17;1188;8144
PE;CEDRO;743;40;155;1477;15;4;160;2594
PE;CHA DE ALEGRIA;840;51;108;869;41;1;200;2110
PE;CHA GRANDE;2345;356;631;2503;38;14;581;6468
PE;CONDADO;2379;148;278;2742;67;5;1260;6879
PE;CORRENTES;712;90;170;1724;16;4;237;2953
PE;CORTES;804;192;131;656;40;7;204;2034
PE;CUMARU;1077;194;268;1973;18;6;321;3857
PE;CUPIRA;3255;303;628;3173;24;34;1417;8834
PE;CUSTODIA;3973;406;991;5073;49;43;1012;11547
PE;DORMENTES;1041;330;362;3061;44;3;361;5202
PE;ESCADA;6808;389;690;7579;171;56;2230;17923
PE;EXU;2499;322;826;4701;39;18;450;8855
PE;FEIRA NOVA;1628;289;335;3106;26;13;1026;6423
PE;FERNANDO DE NORONHA;506;12;130;399;11;46;281;1385
PE;FERREIROS;932;91;161;1577;52;3;332;3148
PE;FLORES;1603;128;397;2751;23;3;312;5217
PE;FLORESTA;2620;517;834;4505;36;24;1016;9552
PE;FREI MIGUELINHO;1555;259;392;1573;26;4;500;4309
PE;GAMELEIRA;1480;84;138;1059;65;8;377;3211
PE;GARANHUNS;26797;1791;4062;17096;156;464;6009;56375
PE;GLORIA DO GOITA;1899;223;385;3363;66;14;716;6666
PE;GOIANA;10718;821;1363;10933;183;160;4802;28980
PE;GRANITO;313;36;127;1056;14;4;42;1592
PE;GRAVATA;11537;1050;2330;13861;103;168;5238;34287
PE;IATI;815;103;277;1439;30;5;184;2853
PE;IBIMIRIM;1966;212;728;2897;25;14;461;6303
PE;IBIRAJUBA;521;50;106;650;11;1;160;1499
PE;IGARASSU;15964;1006;1514;7040;557;108;4028;30217
PE;IGUARACI;838;147;187;1190;34;2;142;2540
PE;ILHA DE ITAMARACA;2240;85;301;1138;22;15;842;4643
PE;INAJA;800;80;319;1639;18;6;172;3034
PE;INGAZEIRA;302;39;71;479;8;0;68;967
PE;IPOJUCA;11044;743;1161;5514;464;178;4213;23317
PE;IPUBI;1520;292;419;4246;39;28;387;6931
PE;ITACURUBA;274;26;85;319;6;0;42;752
PE;ITAIBA;1328;177;497;3465;26;3;280;5776
PE;ITAMBE;3535;417;675;8288;152;22;2186;15275
PE;ITAPETIM;1062;88;253;1919;12;2;267;3603
PE;ITAPISSUMA;2247;127;207;854;23;15;878;4351
PE;ITAQUITINGA;961;46;122;1358;46;2;326;2861
PE;JABOATAO DOS GUARARAPES;110120;5689;10440;56959;2155;1505;20956;207824
PE;JAQUEIRA;588;62;113;825;31;4;172;1795
PE;JATAUBA;885;229;475;1929;16;15;402;3951
PE;JATOBA;753;60;124;992;17;4;301;2251
PE;JOAO ALFREDO;2245;275;766;2997;32;27;1078;7420
PE;JOAQUIM NABUCO;915;85;105;1031;66;6;320;2528
PE;JUCATI;986;121;167;1159;31;2;185;2651
PE;JUPI;1842;242;293;1694;67;8;409;4555
PE;JUREMA;1084;94;219;991;17;7;266;2678
PE;LAGOA DO CARRO;1294;111;225;1259;24;8;590;3511
PE;LAGOA DO ITAENGA;1721;421;307;2545;68;15;811;5888
PE;LAGOA DO OURO;505;52;207;1671;18;7;117;2577
PE;LAGOA DOS GATOS;1037;108;281;1449;7;0;379;3261
PE;LAGOA GRANDE;1375;183;423;2299;19;8;285;4592
PE;LAJEDO;6773;644;1240;5541;67;69;2519;16853
PE;LIMOEIRO;6309;569;1076;8327;87;71;3409;19848
PE;MACAPARANA;2162;212;544;4486;54;22;549;8029
PE;MACHADOS;1016;185;308;1746;22;6;312;3595
PE;MANARI;511;65;208;1501;12;7;93;2397
PE;MARAIAL;559;120;91;956;32;7;262;2027
PE;MIRANDIBA;862;130;265;1399;12;8;150;2826
PE;MOREILANDIA;417;68;184;1191;10;2;47;1919
PE;MORENO;7757;783;961;6094;159;71;1571;17396
PE;NAZARE DA MATA;3592;229;425;2512;61;29;1090;7938
PE;OLINDA;81260;3050;6745;40427;1325;834;11559;145200
PE;OROBO;2380;230;494;2591;87;10;601;6393
PE;OROCO;806;97;214;2041;14;0;105;3277
PE;OURICURI;5339;698;1391;14448;118;68;1376;23438
PE;PALMARES;7286;527;987;9527;224;78;3544;22173
PE;PALMEIRINA;390;22;78;767;7;2;98;1364
PE;PANELAS;1961;120;419;1231;24;7;519;4281
PE;PARANATAMA;1019;156;215;1143;34;8;155;2730
PE;PARNAMIRIM;1221;289;318;3253;31;4;241;5357
PE;PASSIRA;2058;312;456;3645;37;19;719;7246
PE;PAUDALHO;5293;576;614;6302;91;35;1465;14376
PE;PAULISTA;61246;1743;4209;26734;358;368;9329;103987
PE;PEDRA;1355;184;456;1624;27;9;248;3903
PE;PESQUEIRA;7473;820;1551;7733;158;71;2391;20197
PE;PETROLANDIA;3076;375;885;4464;75;23;1313;10211
PE;PETROLINA;57985;4552;11913;57518;654;820;16014;149456
PE;POCAO;992;71;216;2269;14;5;221;3788
PE;POMBOS;2700;480;669;2803;60;31;1108;7851
PE;PRIMAVERA;773;98;135;611;49;11;252;1929
PE;QUIPAPA;1045;103;217;1116;47;6;273;2807
PE;QUIXABA;595;53;352;2020;13;2;129;3164
PE;RECIFE;401518;19530;41904;150782;4023;13002;72941;703700
PE;RIACHO DAS ALMAS;2301;404;503;2745;30;19;569;6571
PE;RIBEIRAO;4151;270;387;3198;108;25;1031;9170
PE;RIO FORMOSO;2025;121;178;1265;86;5;701;4381
PE;SAIRE;909;105;211;1005;21;4;163;2418
PE;SALGADINHO;272;19;78;577;6;1;113;1066
PE;SALGUEIRO;8215;562;1685;12346;93;116;3117;26134
PE;SALOA;995;83;260;1394;14;12;178;2936
PE;SANHARO;1759;164;417;2039;45;6;579;5009
PE;SANTA CRUZ;590;185;202;2017;30;5;111;3140
PE;SANTA CRUZ DA BAIXA VERDE;840;230;310;2582;12;8;259;4241
PE;SANTA CRUZ DO CAPIBARIBE;15565;1070;3656;23890;72;342;10495;55090
PE;SANTA FILOMENA;421;142;187;1781;34;2;85;2652
PE;SANTA MARIA DA BOA VISTA;2574;304;771;5666;85;13;378;9791
PE;SANTA MARIA DO CAMBUCA;1304;234;173;1542;35;4;349;3641
PE;SANTA TEREZINHA;773;88;279;1236;8;1;176;2561
PE;SAO BENEDITO DO SUL;511;32;82;633;17;1;122;1398
PE;SAO BENTO DO UNA;4432;1094;1177;6801;132;54;1776;15466
PE;SAO CAITANO;3810;439;531;4913;45;32;1540;11310
PE;SAO JOAO;1653;150;322;2045;40;17;326;4553
PE;SAO JOAQUIM DO MONTE;1356;91;275;1800;29;9;362;3922
PE;SAO JOSE DA COROA GRANDE;1600;78;203;1100;40;17;601;3639
PE;SAO JOSE DO BELMONTE;3006;345;879;4741;81;33;589;9674
PE;SAO JOSE DO EGITO;4577;526;1144;5647;78;35;1250;13257
PE;SAO LOURENCO DA MATA;13357;449;1152;7506;562;72;2631;25729
PE;SAO VICENTE FERRER;1297;197;481;2323;29;11;325;4663
PE;SERRA TALHADA;12310;1621;2588;18520;105;168;4446;39758
PE;SERRITA;872;103;229;1789;15;12;187;3207
PE;SERTANIA;4267;497;894;9714;64;20;1100;16556
PE;SIRINHAEM;3191;240;297;1890;100;35;983;6736
PE;SOLIDAO;288;25;94;650;9;1;82;1149
PE;SURUBIM;9283;927;2214;10435;137;129;3986;27111
PE;TABIRA;3804;293;854;5888;51;25;1283;12198
PE;TACAIMBO;1131;126;210;1334;22;7;309;3139
PE;TACARATU;744;72;322;1668;11;4;379;3200
PE;TAMANDARE;1807;77;255;1676;36;15;788;4654
PE;TAQUARITINGA DO NORTE;3494;346;683;3123;49;51;1274;9020
PE;TEREZINHA;452;30;108;910;22;1;76;1599
PE;TERRA NOVA;692;84;134;1433;11;0;86;2440
PE;TIMBAUBA;7076;646;1390;13915;128;79;3591;26825
PE;TORITAMA;6030;343;1282;5679;44;140;3050;16568
PE;TRACUNHAEM;968;58;95;920;20;3;280;2344
PE;TRINDADE;2345;410;587;5599;23;29;1259;10252
PE;TRIUNFO;1653;250;687;4381;16;18;337;7342
PE;TUPANATINGA;1235;158;355;2564;32;11;236;4591
PE;TUPARETAMA;1112;121;215;1868;21;3;382;3722
PE;VENTUROSA;1374;205;486;1156;16;6;379;3622
PE;VERDEJANTE;581;70;117;1151;18;2;116;2055
PE;VERTENTE DO LERIO;823;92;130;1592;19;1;229;2886
PE;VERTENTES;2165;233;380;1969;28;16;542;5333
PE;VICENCIA;2854;318;473;2603;88;10;510;6856
PE;VITORIA DE SANTO ANTAO;19873;2462;3406;21087;388;301;8920;56437
PE;XEXEU;891;77;86;835;42;7;200;2138
PI;ACAUA;305;140;246;1057;33;0;62;1843
PI;AGRICOLANDIA;296;23;92;1019;8;2;215;1655
PI;AGUA BRANCA;2226;215;650;7824;24;28;1443;12410
PI;ALAGOINHA DO PIAUI;495;67;265;553;5;2;132;1519
PI;ALEGRETE DO PIAUI;183;46;64;268;4;2;50;617
PI;ALTO LONGA;487;60;195;1866;37;2;187;2834
PI;ALTOS;3475;332;766;8421;80;29;1685;14788
PI;ALVORADA DO GURGUEIA;200;26;75;533;10;0;90;934
PI;AMARANTE;850;91;306;3281;28;9;394;4959
PI;ANGICAL DO PIAUI;341;30;134;1203;11;0;329;2048
PI;ANISIO DE ABREU;467;54;236;892;17;1;75;1742
PI;ANTONIO ALMEIDA;127;29;70;450;6;0;98;780
PI;AROAZES;282;22;66;616;11;0;161;1158
PI;AROEIRAS DO ITAIM;103;19;30;470;13;0;38;673
PI;ARRAIAL;119;13;53;535;4;1;59;784
PI;ASSUNCAO DO PIAUI;144;12;133;350;4;0;18;661
PI;AVELINO LOPES;320;36;256;930;8;6;242;1798
PI;BAIXA GRANDE DO RIBEIRO;416;140;286;1215;26;7;814;2904
PI;BARRA D'ALCANTARA;180;22;67;497;5;0;238;1009
PI;BARRAS;1902;175;605;8002;114;15;1913;12726
PI;BARREIRAS DO PIAUI;56;7;41;174;2;0;18;298
PI;BARRO DURO;407;54;162;1544;6;3;224;2400
PI;BATALHA;856;101;319;2458;23;8;547;4312
PI;BELA VISTA DO PIAUI;184;20;112;296;7;0;48;667
PI;BELEM DO PIAUI;179;43;47;180;3;0;41;493
PI;BENEDITINOS;339;44;162;1532;15;0;302;2394
PI;BERTOLINIA;269;27;110;799;13;0;120;1338
PI;BETANIA DO PIAUI;287;107;225;610;24;1;58;1312
PI;BOA HORA;189;26;83;706;12;0;134;1150
PI;BOCAINA;378;12;119;756;4;4;144;1417
PI;BOM JESUS;2177;384;1350;6159;33;93;2174;12370
PI;BOM PRINCIPIO DO PIAUI;239;15;72;637;12;0;87;1062
PI;BONFIM DO PIAUI;160;47;307;605;10;0;50;1179
PI;BOQUEIRAO DO PIAUI;368;20;61;753;5;0;184;1391
PI;BRASILEIRA;439;31;96;1043;10;6;517;2142
PI;BREJO DO PIAUI;159;11;111;372;3;0;80;736
PI;BURITI DOS LOPES;984;65;208;2655;24;11;425;4372
PI;BURITI DOS MONTES;185;19;95;188;5;2;30;524
PI;CABECEIRAS DO PIAUI;396;34;105;1074;27;0;227;1863
PI;CAJAZEIRAS DO PIAUI;64;6;29;402;3;0;47;551
PI;CAJUEIRO DA PRAIA;264;18;105;935;16;7;125;1470
PI;CALDEIRAO GRANDE DO PIAUI;293;52;91;242;15;3;52;748
PI;CAMPINAS DO PIAUI;217;11;133;556;2;1;74;994
PI;CAMPO ALEGRE DO FIDALGO;269;41;160;340;4;0;52;866
PI;CAMPO GRANDE DO PIAUI;425;58;150;682;5;1;132;1453
PI;CAMPO LARGO DO PIAUI;130;11;42;328;6;0;59;576
PI;CAMPO MAIOR;4728;504;1164;14735;99;57;4983;26270
PI;CANAVIEIRA;44;5;31;157;1;0;13;251
PI;CANTO DO BURITI;1301;125;560;3324;25;18;512;5865
PI;CAPITAO DE CAMPOS;606;43;148;1421;15;5;305;2543
PI;CAPITAO GERVASIO OLIVEIRA;132;31;78;152;8;0;39;440
PI;CARACOL;384;77;159;881;7;1;139;1648
PI;CARAUBAS DO PIAUI;199;31;95;637;9;1;81;1053
PI;CARIDADE DO PIAUI;201;30;88;310;9;0;17;655
PI;CASTELO DO PIAUI;749;80;364;3090;24;11;396;4714
PI;CAXINGO;162;19;68;509;10;2;66;836
PI;COCAL;1567;207;760;3012;43;43;1102;6734
PI;COCAL DE TELHA;273;10;64;710;7;1;226;1291
PI;COCAL DOS ALVES;336;10;155;361;4;4;178;1048
PI;COIVARAS;137;14;39;665;8;0;48;911
PI;COLONIA DO GURGUEIA;275;22;80;616;3;0;101;1097
PI;COLONIA DO PIAUI;303;18;102;1032;10;0;117;1582
PI;CONCEICAO DO CANINDE;224;19;108;325;5;1;28;710
PI;CORONEL JOSE DIAS;155;23;105;605;8;0;77;973
PI;CORRENTE;1533;580;835;4725;86;28;1532;9319
PI;CRISTALANDIA DO PIAUI;182;26;86;475;4;0;107;880
PI;CRISTINO CASTRO;511;56;182;1211;18;7;378;2363
PI;CURIMATA;407;80;201;1292;9;7;371;2367
PI;CURRAIS;116;7;56;461;2;0;55;697
PI;CURRAL NOVO DO PIAUI;135;23;74;269;4;1;21;527
PI;CURRALINHOS;59;6;33;257;2;0;6;363
PI;DEMERVAL LOBAO;987;94;252;2523;43;11;345;4255
PI;DIRCEU ARCOVERDE;299;91;123;812;11;0;101;1437
PI;DOM EXPEDITO LOPES;697;79;173;926;8;2;277;2162
PI;DOM INOCENCIO;183;109;226;507;20;1;72;1118
PI;DOMINGOS MOURAO;106;5;56;271;5;1;37;481
PI;ELESBAO VELOSO;937;83;364;2578;11;6;363;4342
PI;ELISEU MARTINS;183;15;55;595;3;1;61;913
PI;ESPERANTINA;2534;267;835;7034;74;24;2308;13076
PI;FARTURA DO PIAUI;147;33;60;355;5;1;51;652
PI;FLORES DO PIAUI;179;16;77;338;3;1;35;649
PI;FLORESTA DO PIAUI;118;13;52;332;4;1;48;568
PI;FLORIANO;10228;1233;2945;20911;85;179;5436;41017
PI;FRANCINOPOLIS;171;20;72;597;2;0;149;1011
PI;FRANCISCO AYRES;148;11;57;460;7;0;106;789
PI;FRANCISCO MACEDO;229;41;40;228;9;0;35;582
PI;FRANCISCO SANTOS;512;90;178;508;8;5;165;1466
PI;FRONTEIRAS;926;189;326;1981;19;11;422;3874
PI;GEMINIANO;415;42;112;1115;11;2;179;1876
PI;GILBUES;299;23;151;1083;16;6;228;1806
PI;GUADALUPE;761;105;328;1969;9;6;533;3711
PI;GUARIBAS;84;15;100;539;5;0;25;768
PI;HUGO NAPOLEAO;261;10;57;759;2;2;88;1179
PI;ILHA GRANDE;352;17;79;1450;12;8;306;2224
PI;INHUMA;1114;129;456;1686;20;11;610;4026
PI;IPIRANGA DO PIAUI;626;74;166;788;10;3;255;1922
PI;ISAIAS COELHO;169;18;122;583;8;1;80;981
PI;ITAINOPOLIS;578;66;256;1527;28;3;242;2700
PI;ITAUEIRA;405;83;287;1628;8;5;350;2766
PI;JACOBINA DO PIAUI;380;87;232;1262;1;1;74;2037
PI;JAICOS;1217;168;529;2415;15;9;352;4705
PI;JARDIM DO MULATO;127;11;51;358;3;0;87;637
PI;JATOBA DO PIAUI;234;39;128;675;14;0;110;1200
PI;JERUMENHA;177;23;64;487;1;0;103;855
PI;JOAO COSTA;84;6;35;375;3;0;23;526
PI;JOAQUIM PIRES;413;54;138;1170;16;0;153;1944
PI;JOCA MARQUES;102;9;53;542;6;1;40;753
PI;JOSE DE FREITAS;2460;172;615;7400;115;13;1511;12286
PI;JUAZEIRO DO PIAUI;147;28;71;470;6;1;50;773
PI;JULIO BORGES;125;18;93;344;5;1;89;675
PI;JUREMA;148;25;61;348;28;2;17;629
PI;LAGOA ALEGRE;278;19;99;850;33;0;123;1402
PI;LAGOA DE SAO FRANCISCO;231;11;96;673;5;0;147;1163
PI;LAGOA DO BARRO DO PIAUI;226;38;182;271;13;1;51;782
PI;LAGOA DO PIAUI;146;18;54;459;9;1;43;730
PI;LAGOA DO SITIO;178;19;67;355;4;0;83;706
PI;LAGOINHA DO PIAUI;180;6;44;507;4;0;96;837
PI;LANDRI SALES;184;25;53;768;1;0;60;1091
PI;LUIS CORREIA;1559;102;482;4401;60;28;834;7466
PI;LUZILANDIA;1506;145;716;5342;54;19;781;8563
PI;MADEIRO;158;12;61;668;4;0;67;970
PI;MANOEL EMIDIO;200;19;105;497;6;1;102;930
PI;MARCOLANDIA;2423;656;744;1595;25;48;416;5907
PI;MARCOS PARENTE;147;13;67;531;3;1;100;862
PI;MASSAPE DO PIAUI;217;28;103;431;11;0;26;816
PI;MATIAS OLIMPIO;301;34;114;744;9;4;82;1288
PI;MIGUEL ALVES;598;69;263;2796;58;5;279;4068
PI;MIGUEL LEAO;54;6;18;177;1;0;12;268
PI;MILTON BRANDAO;178;17;161;479;6;3;128;972
PI;MONSENHOR GIL;369;41;105;1288;9;3;144;1959
PI;MONSENHOR HIPOLITO;580;53;262;481;7;2;93;1478
PI;MONTE ALEGRE DO PIAUI;325;31;123;700;13;6;205;1403
PI;MORRO CABECA NO TEMPO;34;8;35;163;4;0;21;265
PI;MORRO DO CHAPEU DO PIAUI;198;7;74;512;12;0;86;889
PI;MURICI DOS PORTELAS;147;13;54;524;10;1;40;789
PI;NAZARE DO PIAUI;263;30;110;919;11;2;72;1407
PI;NAZARIA;250;26;79;569;11;2;68;1005
PI;NOSSA SENHORA DE NAZARE;272;19;58;560;15;0;134;1058
PI;NOSSA SENHORA DOS REMEDIOS;166;16;56;937;6;0;119;1300
PI;NOVA SANTA RITA;172;3;83;499;6;0;27;790
PI;NOVO ORIENTE DO PIAUI;343;21;93;852;13;2;194;1518
PI;NOVO SANTO ANTONIO;124;14;59;406;4;0;22;629
PI;OEIRAS;2943;390;1100;8865;62;74;2456;15890
PI;OLHO D'AGUA DO PIAUI;105;7;31;509;3;1;98;754
PI;PADRE MARCOS;514;112;260;633;6;6;159;1690
PI;PAES LANDIM;174;10;68;359;3;0;69;683
PI;PAJEU DO PIAUI;103;14;73;204;3;0;45;442
PI;PALMEIRA DO PIAUI;297;45;166;582;6;1;97;1194
PI;PALMEIRAIS;321;24;102;1123;14;0;128;1712
PI;PAQUETA;182;23;58;386;7;1;44;701
PI;PARNAGUA;163;26;80;829;5;2;142;1247
PI;PARNAIBA;25084;1436;5210;44253;354;781;14832;91950
PI;PASSAGEM FRANCA DO PIAUI;127;10;32;420;6;0;32;627
PI;PATOS DO PIAUI;221;27;142;491;9;0;25;915
PI;PAU D'ARCO DO PIAUI;99;10;51;499;7;0;40;706
PI;PAULISTANA;1825;563;956;6056;174;23;691;10288
PI;PAVUSSU;99;16;64;341;2;1;48;571
PI;PEDRO II;2220;153;1141;5456;28;28;2030;11056
PI;PEDRO LAURENTINO;140;5;40;234;2;1;25;447
PI;PICOS;14757;1924;3893;28898;117;311;7924;57824
PI;PIMENTEIRAS;292;52;153;756;7;1;115;1376
PI;PIO IX;858;163;469;1566;21;6;228;3311
PI;PIRACURUCA;2601;326;907;6340;90;55;1940;12259
PI;PIRIPIRI;6313;445;1483;16423;191;121;6160;31136
PI;PORTO;206;18;76;872;5;0;169;1346
PI;PORTO ALEGRE DO PIAUI;51;12;22;196;2;0;22;305
PI;PRATA DO PIAUI;90;12;35;341;2;0;36;516
PI;QUEIMADA NOVA;373;116;286;721;31;1;90;1618
PI;REDENCAO DO GURGUEIA;246;25;109;1191;14;3;119;1707
PI;REGENERACAO;869;110;347;2628;18;7;725;4704
PI;RIACHO FRIO;56;8;44;338;5;0;61;512
PI;RIBEIRA DO PIAUI;47;12;52;86;3;0;31;231
PI;RIBEIRO GONCALVES;149;32;98;572;4;2;254;1111
PI;RIO GRANDE DO PIAUI;251;32;84;557;7;1;82;1014
PI;SANTA CRUZ DO PIAUI;334;29;124;652;5;0;78;1222
PI;SANTA CRUZ DOS MILAGRES;108;7;33;397;4;0;58;607
PI;SANTA FILOMENA;60;39;67;517;8;2;158;851
PI;SANTA LUZ;218;16;79;582;6;0;141;1042
PI;SANTA ROSA DO PIAUI;149;20;66;516;13;3;198;965
PI;SANTANA DO PIAUI;198;32;73;835;16;1;151;1306
PI;SANTO ANTONIO DE LISBOA;455;59;219;572;6;4;150;1465
PI;SANTO ANTONIO DOS MILAGRES;71;3;11;197;2;2;25;311
PI;SANTO INACIO DO PIAUI;161;15;53;453;2;1;71;756
PI;SAO BRAZ DO PIAUI;169;38;89;353;7;0;31;687
PI;SAO FELIX DO PIAUI;140;8;36;319;3;0;75;581
PI;SAO FRANCISCO DE ASSIS DO PIAU;193;26;119;418;8;1;30;795
PI;SAO FRANCISCO DO PIAUI;153;15;50;541;8;2;56;825
PI;SAO GONCALO DO GURGUEIA;50;5;30;237;1;0;30;353
PI;SAO GONCALO DO PIAUI;314;20;77;942;4;3;207;1567
PI;SAO JOAO DA CANABRAVA;251;23;114;568;7;1;104;1068
PI;SAO JOAO DA FRONTEIRA;127;9;58;205;10;3;53;465
PI;SAO JOAO DA SERRA;167;23;73;836;4;2;140;1245
PI;SAO JOAO DA VARJOTA;196;7;43;446;4;1;80;777
PI;SAO JOAO DO ARRAIAL;220;18;85;645;10;0;112;1090
PI;SAO JOAO DO PIAUI;1467;149;612;3759;25;11;811;6834
PI;SAO JOSE DO DIVINO;222;31;76;657;5;0;96;1087
PI;SAO JOSE DO PEIXE;97;11;49;245;5;0;29;436
PI;SAO JOSE DO PIAUI;364;39;238;685;14;1;292;1633
PI;SAO JULIAO;345;51;110;614;5;3;119;1247
PI;SAO LOURENCO DO PIAUI;240;11;78;437;6;0;52;824
PI;SAO LUIS DO PIAUI;160;14;92;434;3;0;41;744
PI;SAO MIGUEL DA BAIXA GRANDE;89;13;41;298;4;2;62;509
PI;SAO MIGUEL DO FIDALGO;48;7;39;186;4;0;16;300
PI;SAO MIGUEL DO TAPUIO;383;56;324;1691;24;6;226;2710
PI;SAO PEDRO DO PIAUI;578;59;205;2402;10;3;260;3517
PI;SAO RAIMUNDO NONATO;4476;1077;1864;8905;184;83;2085;18674
PI;SEBASTIAO BARROS;57;11;38;216;3;0;56;381
PI;SEBASTIAO LEAL;209;52;87;539;3;2;218;1110
PI;SIGEFREDO PACHECO;306;50;130;962;14;0;147;1609
PI;SIMOES;641;151;299;1383;21;8;250;2753
PI;SIMPLICIO MENDES;952;89;411;1895;13;6;467;3833
PI;SOCORRO DO PIAUI;124;11;89;270;3;0;52;549
PI;SUSSUAPARA;568;56;220;1338;10;3;455;2650
PI;TAMBORIL DO PIAUI;69;7;34;128;1;0;26;265
PI;TANQUE DO PIAUI;118;12;43;305;4;0;70;552
PI;TERESINA;217793;12047;39490;181374;4133;5873;51781;512491
PI;UNIAO;2004;195;510;7392;101;12;1272;11486
PI;URUCUI;1363;241;812;5607;32;40;2264;10359
PI;VALENCA DO PIAUI;2068;212;702;4150;34;23;1449;8638
PI;VARZEA BRANCA;173;41;102;368;33;0;35;752
PI;VARZEA GRANDE;146;18;73;444;4;1;159;845
PI;VERA MENDES;181;20;87;390;4;2;43;727
PI;VILA NOVA DO PIAUI;284;27;86;348;5;1;60;811
PI;WALL FERRAZ;181;17;60;283;9;3;54;607
PR;ABATIA;2210;171;415;878;50;7;251;3982
PR;ADRIANOPOLIS;1499;143;261;893;31;7;279;3113
PR;AGUDOS DO SUL;3252;576;634;1146;47;21;619;6295
PR;ALMIRANTE TAMANDARE;38372;1756;3870;10278;272;216;5934;60698
PR;ALTAMIRA DO PARANA;971;62;258;579;16;3;91;1980
PR;ALTO PARAISO;937;68;250;404;15;3;181;1858
PR;ALTO PARANA;4315;347;847;1482;107;36;1277;8411
PR;ALTO PIQUIRI;2924;236;553;1278;56;25;628;5700
PR;ALTONIA;6558;549;1394;3370;66;45;1947;13929
PR;ALVORADA DO SUL;2937;355;663;702;67;33;1004;5761
PR;AMAPORA;1306;84;223;568;61;3;292;2537
PR;AMPERE;7065;550;1315;2854;65;98;1687;13634
PR;ANAHY;846;111;275;547;10;4;103;1896
PR;ANDIRA;7349;585;1319;2565;103;95;2099;14115
PR;ANGULO;961;94;230;337;12;2;222;1858
PR;ANTONINA;3160;136;323;1144;45;22;634;5464
PR;ANTONIO OLINTO;2256;242;437;959;46;6;279;4225
PR;APUCARANA;50677;2724;7393;15691;375;762;10198;87820
PR;ARAPONGAS;46944;3472;6785;16185;194;675;14953;89208
PR;ARAPOTI;8265;834;1795;2277;88;97;1773;15129
PR;ARAPUA;957;142;271;631;31;2;172;2206
PR;ARARUNA;4543;474;968;2225;51;23;931;9215
PR;ARAUCARIA;56847;3073;6719;11243;628;475;11456;90441
PR;ARIRANHA DO IVAI;669;67;210;354;24;1;37;1362
PR;ASSAI;5988;522;1055;2231;53;47;1156;11052
PR;ASSIS CHATEAUBRIAND;13538;1359;3088;4411;98;146;4412;27052
PR;ASTORGA;9635;793;1990;2799;117;81;3335;18750
PR;ATALAIA;1307;138;303;570;37;4;352;2711
PR;BALSA NOVA;4737;437;775;1585;174;35;1050;8793
PR;BANDEIRANTES;11815;966;1909;3844;120;135;2520;21309
PR;BARBOSA FERRAZ;3233;262;694;1710;42;15;475;6431
PR;BARRA DO JACARE;879;71;155;450;20;1;109;1685
PR;BARRACAO;4985;333;828;1022;56;44;1479;8747
PR;BELA VISTA DO CAROBA;1229;86;189;739;29;6;136;2414
PR;BELA VISTA DO PARAISO;6494;481;1193;1409;77;54;1764;11472
PR;BITURUNA;5475;561;1384;1343;228;43;986;10020
PR;BOA ESPERANCA;1521;216;475;703;19;15;481;3430
PR;BOA ESPERANCA DO IGUACU;846;76;183;451;16;6;160;1738
PR;BOA VENTURA DE SAO ROQUE;1687;256;476;790;52;10;273;3544
PR;BOA VISTA DA APARECIDA;2571;213;440;1050;35;23;518;4850
PR;BOCAIUVA DO SUL;4181;406;623;1288;34;34;666;7232
PR;BOM JESUS DO SUL;1176;50;199;537;13;6;118;2099
PR;BOM SUCESSO;2005;150;351;571;61;9;297;3444
PR;BOM SUCESSO DO SUL;1038;152;392;356;17;34;237;2226
PR;BORRAZOPOLIS;2944;341;718;979;24;24;422;5452
PR;BRAGANEY;1674;214;456;924;31;21;230;3550
PR;BRASILANDIA DO SUL;987;94;244;503;13;6;240;2087
PR;CAFEARA;895;57;143;289;19;3;141;1547
PR;CAFELANDIA;6683;784;1542;1898;133;91;2009;13140
PR;CAFEZAL DO SUL;1398;114;268;538;35;8;228;2589
PR;CALIFORNIA;3415;328;722;1154;32;30;574;6255
PR;CAMBARA;8979;886;1577;3421;113;79;2402;17457
PR;CAMBE;39017;2243;5503;12672;155;337;9558;69485
PR;CAMBIRA;3112;318;710;1015;34;26;556;5771
PR;CAMPINA DA LAGOA;5075;539;1125;1843;62;60;1071;9775
PR;CAMPINA DO SIMAO;985;152;273;308;41;6;107;1872
PR;CAMPINA GRANDE DO SUL;17006;903;1974;3248;100;144;2402;25777
PR;CAMPO BONITO;1381;130;298;401;24;3;144;2381
PR;CAMPO DO TENENTE;2464;187;345;522;61;9;342;3930
PR;CAMPO LARGO;51130;2707;7062;12518;529;660;8803;83409
PR;CAMPO MAGRO;9438;657;1355;2633;53;97;1156;15389
PR;CAMPO MOURAO;39186;2746;6840;12277;633;569;10580;72831
PR;CANDIDO DE ABREU;3755;346;927;2173;61;17;525;7804
PR;CANDOI;4951;518;1003;1149;127;31;634;8413
PR;CANTAGALO;3489;319;765;761;69;21;449;5873
PR;CAPANEMA;7674;579;1298;2473;88;83;1393;13588
PR;CAPITAO LEONIDAS MARQUES;6135;697;1299;1841;85;79;1633;11769
PR;CARAMBEI;8320;777;1612;1606;90;96;1978;14479
PR;CARLOPOLIS;4788;367;1080;1943;95;36;1020;9329
PR;CASCAVEL;144868;8547;22286;35183;1136;3022;33832;248874
PR;CASTRO;25061;2319;5278;6613;434;342;4860;44907
PR;CATANDUVAS;3019;275;669;924;57;29;360;5333
PR;CENTENARIO DO SUL;3717;186;517;1335;93;28;736;6612
PR;CERRO AZUL;3447;617;953;2425;76;20;1002;8540
PR;CEU AZUL;4322;421;958;1116;67;47;1534;8465
PR;CHOPINZINHO;7986;735;1798;1704;115;149;1692;14179
PR;CIANORTE;30021;1774;5623;12186;280;377;12353;62614
PR;CIDADE GAUCHA;3680;327;612;1443;104;30;1265;7461
PR;CLEVELANDIA;6306;689;1370;959;62;67;1168;10621
PR;COLOMBO;89798;4557;10071;23151;625;693;13998;142893
PR;COLORADO;8761;632;1664;2759;189;108;3476;17589
PR;CONGONHINHAS;2394;152;461;913;49;6;260;4235
PR;CONSELHEIRO MAIRINCK;1174;67;195;307;19;7;102;1871
PR;CONTENDA;6742;875;1254;1445;68;36;1003;11423
PR;CORBELIA;6665;869;1765;1736;71;154;1847;13107
PR;CORNELIO PROCOPIO;18655;1165;3059;7599;154;250;4415;35297
PR;CORONEL DOMINGOS SOARES;1360;190;370;433;42;7;155;2557
PR;CORONEL VIVIDA;9205;857;1997;2012;131;108;1447;15757
PR;CORUMBATAI DO SUL;1141;76;281;538;31;1;117;2185
PR;CRUZ MACHADO;5437;786;1605;2684;113;19;553;11197
PR;CRUZEIRO DO IGUACU;1496;102;276;492;30;4;285;2685
PR;CRUZEIRO DO OESTE;8040;597;1179;3032;99;63;1855;14865
PR;CRUZEIRO DO SUL;1714;102;286;542;25;13;477;3159
PR;CRUZMALTINA;855;117;231;343;15;2;132;1695
PR;CURITIBA;1086316;38459;114261;152078;6893;26750;170823;1595580
PR;CURIUVA;4319;329;738;1497;96;25;619;7623
PR;DIAMANTE D'OESTE;1417;89;230;560;48;5;141;2490
PR;DIAMANTE DO NORTE;1941;84;272;770;37;16;636;3756
PR;DIAMANTE DO SUL;857;44;179;421;17;2;65;1585
PR;DOIS VIZINHOS;17932;1390;3317;4899;178;221;4494;32431
PR;DOURADINA;2574;386;511;1259;30;33;1369;6162
PR;DOUTOR CAMARGO;2016;214;493;798;66;13;696;4296
PR;DOUTOR ULYSSES;721;101;178;437;34;2;141;1614
PR;ENEAS MARQUES;2138;253;494;799;34;8;619;4345
PR;ENGENHEIRO BELTRAO;4774;573;1010;1460;114;41;1046;9018
PR;ENTRE RIOS DO OESTE;1538;175;462;532;14;40;584;3345
PR;ESPERANCA NOVA;681;38;130;371;9;3;107;1339
PR;ESPIGAO ALTO DO IGUACU;1111;101;274;360;17;5;148;2016
PR;FAROL;937;115;219;374;21;5;140;1811
PR;FAXINAL;5924;543;1231;2097;63;55;1045;10958
PR;FAZENDA RIO GRANDE;39063;1576;3560;7749;348;218;4741;57255
PR;FENIX;1461;148;272;566;21;13;243;2724
PR;FERNANDES PINHEIRO;1695;135;246;557;33;4;193;2863
PR;FIGUEIRA;2526;165;418;645;49;23;446;4272
PR;FLOR DA SERRA DO SUL;1459;123;284;434;36;4;203;2543
PR;FLORAI;1820;180;418;511;26;13;663;3631
PR;FLORESTA;2945;314;859;924;42;46;805;5935
PR;FLORESTOPOLIS;3792;221;463;614;137;12;1035;6274
PR;FLORIDA;973;77;236;270;31;6;214;1807
PR;FORMOSA DO OESTE;3132;336;793;1302;30;27;563;6183
PR;FOZ DO IGUACU;117921;3986;12422;34406;1609;1751;24047;196142
PR;FOZ DO JORDAO;1881;90;230;226;26;13;196;2662
PR;FRANCISCO ALVES;2054;204;415;1188;40;11;578;4490
PR;FRANCISCO BELTRAO;36981;2454;6555;9629;278;833;10611;67341
PR;GENERAL CARNEIRO;4008;525;906;607;108;13;629;6796
PR;GODOY MOREIRA;809;78;203;625;17;4;84;1820
PR;GOIOERE;10693;692;1953;3134;67;158;3114;19811
PR;GOIOXIM;1521;154;383;588;49;6;153;2854
PR;GRANDES RIOS;1684;129;406;789;24;6;171;3209
PR;GUAIRA;13029;1193;2381;5318;669;186;6057;28833
PR;GUAIRACA;1724;140;353;784;35;6;402;3444
PR;GUAMIRANGA;2347;200;515;1117;42;10;346;4577
PR;GUAPIRAMA;1132;139;221;421;28;10;315;2266
PR;GUAPOREMA;640;62;149;283;15;4;133;1286
PR;GUARACI;1930;124;318;450;47;9;277;3155
PR;GUARANIACU;4927;501;1180;1263;66;44;930;8911
PR;GUARAPUAVA;70631;5154;12345;12921;566;1217;13594;116428
PR;GUARAQUECABA;407;35;97;275;19;8;65;906
PR;GUARATUBA;10219;542;1469;2809;73;115;2787;18014
PR;HONORIO SERPA;1796;136;377;582;42;9;176;3118
PR;IBAITI;9802;678;1619;2613;184;99;1562;16557
PR;IBEMA;2038;179;355;520;21;17;392;3522
PR;IBIPORA;19786;1315;2858;6399;203;115;4385;35061
PR;ICARAIMA;2915;210;649;1373;51;19;762;5979
PR;IGUARACU;1677;129;310;475;18;20;352;2981
PR;IGUATU;551;62;141;435;10;0;56;1255
PR;IMBAU;3307;282;612;1247;44;22;612;6126
PR;IMBITUVA;10545;893;1657;2972;82;144;1943;18236
PR;INACIO MARTINS;2273;320;531;750;54;15;314;4257
PR;INAJA;924;33;163;304;19;7;186;1636
PR;INDIANOPOLIS;1621;198;321;516;20;9;666;3351
PR;IPIRANGA;4508;405;947;1605;111;25;598;8199
PR;IPORA;5136;463;1071;2450;50;48;1651;10869
PR;IRACEMA DO OESTE;819;87;215;323;8;7;141;1600
PR;IRATI;23517;1867;3953;5673;184;308;3950;39452
PR;IRETAMA;3004;253;616;1528;55;14;323;5793
PR;ITAGUAJE;1733;81;271;553;31;7;419;3095
PR;ITAIPULANDIA;3574;288;694;1282;57;37;1161;7093
PR;ITAMBARACA;2064;214;402;675;38;8;362;3763
PR;ITAMBE;2051;216;438;856;39;20;622;4242
PR;ITAPEJARA D'OESTE;4301;423;996;1034;56;40;903;7753
PR;ITAPERUCU;8702;756;1557;2215;118;59;1193;14600
PR;ITAUNA DO SUL;1139;54;137;547;16;2;226;2121
PR;IVAI;4075;428;1114;2208;54;47;408;8334
PR;IVAIPORA;12928;1072;2875;4072;129;110;2810;23996
PR;IVATE;2197;253;398;971;86;11;893;4809
PR;IVATUBA;864;65;175;291;10;2;169;1576
PR;JABOTI;1308;73;331;734;30;10;164;2650
PR;JACAREZINHO;13528;646;1958;5340;171;145;3069;24857
PR;JAGUAPITA;4357;425;1000;1291;96;28;1166;8363
PR;JAGUARIAIVA;10425;813;1879;3089;153;100;2154;18613
PR;JANDAIA DO SUL;8729;717;1889;2152;73;91;1903;15554
PR;JANIOPOLIS;1852;168;512;791;34;12;329;3698
PR;JAPIRA;1372;67;224;406;22;2;139;2232
PR;JAPURA;3095;365;830;1248;32;28;944;6542
PR;JARDIM ALEGRE;4020;327;830;1581;54;18;1004;7834
PR;JARDIM OLINDA;679;48;76;195;10;0;85;1093
PR;JATAIZINHO;4371;395;738;1452;35;22;1015;8028
PR;JESUITAS;3494;379;904;1277;47;14;720;6835
PR;JOAQUIM TAVORA;3622;309;770;1256;45;30;754;6786
PR;JUNDIAI DO SUL;759;40;135;266;36;3;65;1304
PR;JURANDA;2659;350;826;1095;19;31;800;5780
PR;JUSSARA;2259;194;419;796;53;10;933;4664
PR;KALORE;1551;172;404;705;26;6;232;3096
PR;LAPA;16238;1422;2783;4681;246;149;3168;28687
PR;LARANJAL;1194;81;286;726;32;3;101;2423
PR;LARANJEIRAS DO SUL;11971;996;2479;2254;125;141;1792;19758
PR;LEOPOLIS;1172;103;257;405;13;5;171;2126
PR;LIDIANOPOLIS;1186;116;308;599;31;7;303;2550
PR;LINDOESTE;1790;130;360;554;38;10;327;3209
PR;LOANDA;7809;497;1627;3108;76;98;3033;16248
PR;LOBATO;1423;183;417;450;42;11;519;3045
PR;LONDRINA;239644;9508;31758;72861;1985;4325;47214;407295
PR;LUIZIANA;1940;223;408;653;30;8;251;3513
PR;LUNARDELLI;1637;120;323;773;16;5;173;3047
PR;LUPIONOPOLIS;1524;111;298;508;64;4;263;2772
PR;MALLET;4354;551;1006;1775;93;31;720;8530
PR;MAMBORE;5108;690;1592;1657;52;89;1449;10637
PR;MANDAGUACU;8212;556;1381;2526;69;64;2226;15034
PR;MANDAGUARI;14016;972;2411;4657;90;182;3945;26273
PR;MANDIRITUBA;8720;1209;1500;2320;99;80;1996;15924
PR;MANFRINOPOLIS;857;48;136;336;23;4;71;1475
PR;MANGUEIRINHA;5946;631;1273;1435;111;52;1052;10500
PR;MANOEL RIBAS;4306;466;1135;1359;44;59;944;8313
PR;MARECHAL CANDIDO RONDON;22109;1744;4150;7712;243;342;9705;46005
PR;MARIA HELENA;1616;144;340;856;40;5;381;3382
PR;MARIALVA;14326;1105;2929;4365;116;219;4512;27572
PR;MARILANDIA DO SUL;3068;287;606;1277;41;14;570;5863
PR;MARILENA;2287;135;366;1370;39;8;550;4755
PR;MARILUZ;2905;218;472;1272;83;5;704;5659
PR;MARINGA;178679;10317;28924;49309;1011;4350;58828;331418
PR;MARIOPOLIS;2229;280;614;558;44;33;404;4162
PR;MARIPA;2246;401;813;693;16;25;582;4776
PR;MARMELEIRO;5913;484;1119;1329;65;76;1830;10816
PR;MARQUINHO;1157;91;337;486;26;4;83;2184
PR;MARUMBI;1436;120;398;618;32;13;260;2877
PR;MATELANDIA;7080;773;1211;2033;101;76;1945;13219
PR;MATINHOS;10085;407;1167;3179;62;128;2436;17464
PR;MATO RICO;739;112;250;473;18;0;48;1640
PR;MAUA DA SERRA;3255;278;526;975;33;31;570;5668
PR;MEDIANEIRA;20395;1428;3811;5722;144;320;6123;37943
PR;MERCEDES;2136;320;594;1223;32;40;927;5272
PR;MIRADOR;543;21;86;220;11;0;90;971
PR;MIRASELVA;661;42;145;220;34;2;136;1240
PR;MISSAL;3996;443;1023;1610;54;79;1389;8594
PR;MOREIRA SALES;3351;324;672;1526;110;10;751;6744
PR;MORRETES;4343;262;659;1830;48;56;1112;8310
PR;MUNHOZ DE MELLO;1320;91;316;353;14;6;220;2320
PR;NOSSA SENHORA DAS GRACAS;1254;54;198;291;44;4;203;2048
PR;NOVA ALIANCA DO IVAI;402;27;72;222;11;0;78;812
PR;NOVA AMERICA DA COLINA;1085;119;177;350;31;8;210;1980
PR;NOVA AURORA;4818;522;1164;1254;56;32;1374;9220
PR;NOVA CANTU;1936;175;450;933;33;5;203;3735
PR;NOVA ESPERANCA;10316;849;1896;3445;101;113;3772;20492
PR;NOVA ESPERANCA DO SUDOESTE;1762;205;360;669;30;10;371;3407
PR;NOVA FATIMA;2576;318;414;688;56;15;299;4366
PR;NOVA LARANJEIRAS;2485;208;656;893;42;17;314;4615
PR;NOVA LONDRINA;5760;399;813;2066;77;57;1927;11099
PR;NOVA OLIMPIA;1914;128;386;835;37;24;564;3888
PR;NOVA PRATA DO IGUACU;3673;334;798;1388;49;31;771;7044
PR;NOVA SANTA BARBARA;1405;164;254;490;13;9;232;2567
PR;NOVA SANTA ROSA;3423;481;996;1171;24;50;1021;7166
PR;NOVA TEBAS;1992;156;482;910;34;3;158;3735
PR;NOVO ITACOLOMI;1000;118;265;490;17;5;123;2018
PR;ORTIGUEIRA;5795;569;1306;2314;108;36;957;11085
PR;OURIZONA;1199;110;176;406;21;7;225;2144
PR;OURO VERDE DO OESTE;1720;198;430;727;23;14;286;3398
PR;PAICANDU;14288;687;1813;5677;68;50;3709;26292
PR;PALMAS;14761;1227;2907;2580;137;191;2607;24410
PR;PALMEIRA;12376;1161;2536;2850;123;120;2684;21850
PR;PALMITAL;3863;350;1158;1454;81;18;510;7434
PR;PALOTINA;12543;1440;3516;3322;296;212;5120;26449
PR;PARAISO DO NORTE;4380;317;837;1377;90;33;1503;8537
PR;PARANACITY;3264;305;488;965;63;25;1143;6253
PR;PARANAGUA;38206;2119;3519;18351;240;388;13766;76589
PR;PARANAPOEMA;958;80;113;226;25;6;162;1570
PR;PARANAVAI;33281;2296;6627;14155;273;391;12024;69047
PR;PATO BRAGADO;1992;213;474;629;28;25;640;4001
PR;PATO BRANCO;36243;2501;7073;7839;429;944;7883;62912
PR;PAULA FREITAS;1880;228;415;596;34;10;325;3488
PR;PAULO FRONTIN;2524;324;541;902;32;18;363;4704
PR;PEABIRU;4575;409;872;1458;40;23;694;8071
PR;PEROBAL;2173;160;444;788;35;4;460;4064
PR;PEROLA;4443;267;794;2114;24;38;1197;8877
PR;PEROLA D'OESTE;2346;237;424;899;28;31;627;4592
PR;PIEN;4904;489;898;1753;35;34;886;8999
PR;PINHAIS;56653;2314;6364;13697;535;876;9236;89675
PR;PINHAL DO SAO BENTO;697;47;126;449;20;3;59;1401
PR;PINHALAO;1861;149;422;745;28;11;148;3364
PR;PINHAO;8581;707;2046;1725;166;50;1026;14301
PR;PIRAI DO SUL;8395;537;1447;2123;140;33;1375;14050
PR;PIRAQUARA;31265;706;2380;9069;255;166;4155;47996
PR;PITANGA;11699;1146;2894;3487;157;117;2637;22137
PR;PITANGUEIRAS;1052;66;179;292;38;3;164;1794
PR;PLANALTINA DO PARANA;1272;123;294;603;28;9;334;2663
PR;PLANALTO;4604;471;778;2065;57;43;846;8864
PR;PONTA GROSSA;133086;6822;19664;27205;1285;2201;30128;220391
PR;PONTAL DO PARANA;7147;360;954;1877;80;72;1459;11949
PR;PORECATU;5076;299;509;1061;197;46;1418;8606
PR;PORTO AMAZONAS;1390;100;220;263;25;7;216;2221
PR;PORTO BARREIRO;928;106;249;402;33;6;107;1831
PR;PORTO RICO;796;34;172;356;13;12;353;1736
PR;PORTO VITORIA;1251;182;250;392;20;7;228;2330
PR;PRADO FERREIRA;1221;122;200;238;20;6;277;2084
PR;PRANCHITA;2292;329;656;759;24;50;760;4870
PR;PRESIDENTE CASTELO BRANCO;1809;141;275;499;34;13;458;3229
PR;PRIMEIRO DE MAIO;3640;364;834;1247;40;20;1378;7523
PR;PRUDENTOPOLIS;15682;1648;4536;6416;213;159;2343;30997
PR;QUARTO CENTENARIO;1464;141;297;444;12;9;334;2701
PR;QUATIGUA;2675;399;626;981;26;30;748;5485
PR;QUATRO BARRAS;10550;788;1206;1905;128;134;2156;16867
PR;QUATRO PONTES;1741;216;498;666;9;15;762;3907
PR;QUEDAS DO IGUACU;10737;852;1890;2929;206;112;2163;18889
PR;QUERENCIA DO NORTE;3095;270;617;1541;45;11;703;6282
PR;QUINTA DO SOL;1477;171;304;575;31;12;215;2785
PR;QUITANDINHA;5829;620;1136;2117;112;20;991;10825
PR;RAMILANDIA;1154;67;151;448;26;5;88;1939
PR;RANCHO ALEGRE;1291;118;226;438;22;11;243;2349
PR;RANCHO ALEGRE D'OESTE;858;89;223;364;16;6;429;1985
PR;REALEZA;7593;715;1590;2213;57;117;2212;14497
PR;REBOUCAS;4711;337;763;1516;68;20;513;7928
PR;RENASCENCA;2446;292;658;687;46;38;635;4802
PR;RESERVA;7413;801;1717;2790;130;54;1476;14381
PR;RESERVA DO IGUACU;1787;91;308;368;30;4;181;2769
PR;RIBEIRAO CLARO;3840;250;943;1615;45;48;951;7692
PR;RIBEIRAO DO PINHAL;4344;258;654;1139;92;22;645;7154
PR;RIO AZUL;5422;378;921;1817;56;19;704;9317
PR;RIO BOM;1169;103;277;509;16;4;113;2191
PR;RIO BONITO DO IGUACU;4435;376;874;1619;113;20;356;7793
PR;RIO BRANCO DO IVAI;1087;44;215;527;17;4;163;2057
PR;RIO BRANCO DO SUL;10641;752;1899;2944;208;82;2165;18691
PR;RIO NEGRO;14393;1178;2080;3993;89;79;2425;24237
PR;ROLANDIA;24539;1685;3290;7607;146;219;7276;44762
PR;RONCADOR;3375;428;866;1393;50;17;478;6607
PR;RONDON;3327;318;638;1033;88;30;1021;6455
PR;ROSARIO DO IVAI;1379;121;383;914;31;11;222;3061
PR;SABAUDIA;2603;275;612;874;35;27;676;5102
PR;SALGADO FILHO;1734;111;336;665;42;8;258;3154
PR;SALTO DO ITARARE;1794;143;323;679;32;9;221;3201
PR;SALTO DO LONTRA;5169;368;960;1634;48;52;916;9147
PR;SANTA AMELIA;1054;76;190;451;23;4;126;1924
PR;SANTA CECILIA DO PAVAO;1244;117;256;430;18;5;199;2269
PR;SANTA CRUZ DO MONTE CASTELO;3014;236;574;1282;60;11;664;5841
PR;SANTA FE;3815;325;817;1112;47;61;1273;7450
PR;SANTA HELENA;9051;791;1929;3371;168;98;3116;18524
PR;SANTA INES;546;20;86;147;9;2;68;878
PR;SANTA ISABEL DO IVAI;3054;200;614;1372;39;20;848;6147
PR;SANTA IZABEL DO OESTE;3591;276;776;1502;46;57;864;7112
PR;SANTA LUCIA;1321;145;346;459;18;17;238;2544
PR;SANTA MARIA DO OESTE;3039;301;735;1020;36;12;314;5457
PR;SANTA MARIANA;3823;341;680;1060;55;27;1236;7222
PR;SANTA MONICA;877;52;123;460;21;2;209;1744
PR;SANTA TEREZA DO OESTE;4185;319;792;891;26;43;834;7090
PR;SANTA TEREZINHA DE ITAIPU;8362;526;1393;1732;72;86;1971;14142
PR;SANTANA DO ITARARE;1426;125;255;706;30;11;246;2799
PR;SANTO ANTONIO DA PLATINA;14893;798;2782;6648;264;199;3784;29368
PR;SANTO ANTONIO DO CAIUA;761;27;141;398;19;2;157;1505
PR;SANTO ANTONIO DO PARAISO;862;82;147;189;18;3;81;1382
PR;SANTO ANTONIO DO SUDOESTE;7254;516;1137;2225;49;100;1271;12552
PR;SANTO INACIO;2147;167;465;570;29;25;581;3984
PR;SAO CARLOS DO IVAI;1932;239;368;924;39;18;819;4339
PR;SAO JERONIMO DA SERRA;2989;249;576;1095;36;11;274;5230
PR;SAO JOAO;4520;474;1033;979;68;48;748;7870
PR;SAO JOAO DO CAIUA;1899;96;338;565;53;9;343;3303
PR;SAO JOAO DO IVAI;3716;399;898;2048;44;36;678;7819
PR;SAO JOAO DO TRIUNFO;4086;314;807;1407;66;17;420;7117
PR;SAO JORGE D'OESTE;3610;302;791;1132;59;33;685;6612
PR;SAO JORGE DO IVAI;1743;296;609;564;26;25;817;4080
PR;SAO JORGE DO PATROCINIO;2017;154;448;1228;29;28;409;4313
PR;SAO JOSE DA BOA VISTA;1484;138;342;1023;32;8;317;3344
PR;SAO JOSE DAS PALMEIRAS;1285;103;262;517;44;7;205;2423
PR;SAO JOSE DOS PINHAIS;131354;8122;15212;26472;938;1526;27327;210951
PR;SAO MANOEL DO PARANA;638;63;101;310;10;1;145;1268
PR;SAO MATEUS DO SUL;15964;1254;2897;4368;218;168;2919;27788
PR;SAO MIGUEL DO IGUACU;10347;986;2365;2724;112;140;2684;19358
PR;SAO PEDRO DO IGUACU;1878;211;469;722;47;11;324;3662
PR;SAO PEDRO DO IVAI;3035;382;698;1216;58;17;932;6338
PR;SAO PEDRO DO PARANA;815;56;140;312;10;5;230;1568
PR;SAO SEBASTIAO DA AMOREIRA;2833;218;449;711;59;31;372;4673
PR;SAO TOME;1942;174;314;720;37;4;520;3711
PR;SAPOPEMA;2006;132;376;799;24;7;216;3560
PR;SARANDI;32901;1238;3879;15341;232;144;10769;64504
PR;SAUDADE DO IGUACU;2017;120;396;465;35;23;269;3325
PR;SENGES;4993;603;917;1851;85;51;933;9433
PR;SERRANOPOLIS DO IGUACU;1801;167;510;613;13;10;386;3500
PR;SERTANEJA;2201;234;441;571;43;14;465;3969
PR;SERTANOPOLIS;5844;683;1513;2202;80;62;2630;13014
PR;SIQUEIRA CAMPOS;6960;482;1305;2839;76;68;1588;13318
PR;SULINA;1176;98;241;401;18;10;187;2131
PR;TAMARANA;3621;373;659;1693;64;21;525;6956
PR;TAMBOARA;1411;110;362;890;21;10;417;3221
PR;TAPEJARA;5044;470;785;1697;128;26;1772;9922
PR;TAPIRA;1861;176;392;1010;37;8;491;3975
PR;TEIXEIRA SOARES;3075;253;595;990;142;19;446;5520
PR;TELEMACO BORBA;27729;1228;3587;8141;261;368;6468;47782
PR;TERRA BOA;6096;427;1128;2121;137;36;2312;12257
PR;TERRA RICA;5130;436;884;2680;125;28;2049;11332
PR;TERRA ROXA;6095;652;1312;2337;76;85;2376;12933
PR;TIBAGI;5211;424;1055;1194;87;54;848;8873
PR;TIJUCAS DO SUL;5217;588;897;1948;51;36;792;9529
PR;TOLEDO;57908;3826;10710;18149;275;993;18502;110363
PR;TOMAZINA;2053;135;487;948;33;13;280;3949
PR;TRES BARRAS DO PARANA;3710;403;772;1473;46;27;735;7166
PR;TUNAS DO PARANA;1654;157;289;718;58;13;323;3212
PR;TUNEIRAS DO OESTE;2202;171;490;1469;83;7;435;4857
PR;TUPASSI;2902;402;959;1026;45;33;886;6253
PR;TURVO;4472;482;1100;1456;99;46;611;8266
PR;UBIRATA;8848;827;2277;2812;92;99;2540;17495
PR;UMUARAMA;43452;3045;8410;16106;309;920;15516;87758
PR;UNIAO DA VITORIA;20219;1698;3180;5239;102;201;3914;34553
PR;UNIFLOR;849;64;133;269;14;2;146;1477
PR;URAI;3779;382;817;1407;29;32;661;7107
PR;VENTANIA;2772;212;497;998;36;15;522;5052
PR;VERA CRUZ DO OESTE;3138;331;687;783;29;23;809;5800
PR;VERE;2857;311;749;927;27;48;524;5443
PR;VIRMOND;1349;142;346;278;29;8;183;2335
PR;VITORINO;2297;332;611;399;42;40;677;4398
PR;WENCESLAU BRAZ;6251;587;1162;2236;100;44;1153;11533
PR;XAMBRE;1858;158;322;822;22;5;410;3597
RJ;ANGRA DOS REIS;35850;1265;4092;11899;388;571;7089;61154
RJ;APERIBE;2434;149;284;2476;17;5;1183;6548
RJ;ARARUAMA;40635;1930;3825;11455;186;447;8064;66542
RJ;AREAL;3450;202;433;1383;55;33;668;6224
RJ;ARMACAO DE BUZIOS;11935;388;1552;4045;73;423;3417;21833
RJ;ARRAIAL DO CABO;7624;208;800;1905;17;108;1547;12209
RJ;BARRA DO PIRAI;24085;1409;2249;4454;332;215;4280;37024
RJ;BARRA MANSA;52997;1990;4964;8187;649;451;6979;76217
RJ;BELFORD ROXO;79051;2166;5160;20068;720;223;10214;117602
RJ;BOM JARDIM;7871;692;1135;2927;58;89;1629;14401
RJ;BOM JESUS DO ITABAPOANA;5981;306;622;5084;65;17;2015;14090
RJ;CABO FRIO;66633;3089;7092;18226;454;920;14465;110879
RJ;CACHOEIRAS DE MACACU;14453;1005;1709;5231;59;150;3070;25677
RJ;CAMBUCI;2079;127;279;2214;35;14;871;5619
RJ;CAMPOS DOS GOYTACAZES;133676;6849;12408;38765;1478;1130;31205;225511
RJ;CANTAGALO;4611;222;602;1835;49;32;733;8084
RJ;CARAPEBUS;2644;151;305;1251;26;23;738;5138
RJ;CARDOSO MOREIRA;2118;169;283;1406;72;10;776;4834
RJ;CARMO;3371;164;486;1152;19;22;515;5729
RJ;CASIMIRO DE ABREU;9457;668;1194;2982;34;88;2514;16937
RJ;COMENDADOR LEVY GASPARIAN;1696;185;198;700;21;15;365;3180
RJ;CONCEICAO DE MACABU;4753;196;575;2896;54;36;1287;9797
RJ;CORDEIRO;6793;291;725;1835;59;91;895;10689
RJ;DUAS BARRAS;2632;161;376;855;13;23;488;4548
RJ;DUQUE DE CAXIAS;188350;9848;16345;39104;3861;1006;29710;288224
RJ;ENGENHEIRO PAULO DE FRONTIN;3341;131;274;1107;21;18;529;5421
RJ;GUAPIMIRIM;10081;477;1101;3661;55;94;2097;17566
RJ;IGUABA GRANDE;7778;215;637;2120;44;51;1565;12410
RJ;ITABORAI;56321;3170;5215;13677;524;354;9151;88412
RJ;ITAGUAI;34432;1725;2863;5779;359;245;6109;51512
RJ;ITALVA;2640;210;296;1900;33;10;1239;6328
RJ;ITAOCARA;5819;389;918;5088;46;35;2475;14770
RJ;ITAPERUNA;20421;1005;2195;15647;120;156;7179;46723
RJ;ITATIAIA;4687;158;459;1594;50;228;949;8125
RJ;JAPERI;11413;531;838;4029;43;39;2080;18973
RJ;LAJE DO MURIAE;969;43;142;800;18;7;247;2226
RJ;MACAE;63443;3118;7733;21582;884;1380;16166;114306
RJ;MACUCO;2173;205;258;715;14;16;302;3683
RJ;MAGE;46410;2080;4188;14048;202;337;8964;76229
RJ;MANGARATIBA;9141;201;1182;2076;137;136;1887;14760
RJ;MARICA;43130;1331;4044;11658;444;565;7356;68528
RJ;MENDES;4621;208;433;1283;56;38;765;7404
RJ;MESQUITA;34023;844;2152;7612;660;134;4440;49865
RJ;MIGUEL PEREIRA;9840;399;1294;3446;61;149;1515;16704
RJ;MIRACEMA;5055;265;566;3683;39;34;2025;11667
RJ;NATIVIDADE;2673;92;300;1816;50;12;926;5869
RJ;NILOPOLIS;39814;641;2204;8559;318;196;4836;56568
RJ;NITEROI;188493;2827;12533;34473;2438;5949;25868;272581
RJ;NOVA FRIBURGO;80143;3731;7904;21436;376;1229;10624;125443
RJ;NOVA IGUACU;180857;6868;13177;39403;1740;1046;24457;267548
RJ;PARACAMBI;12567;722;1166;2541;114;109;2702;19921
RJ;PARAIBA DO SUL;9819;621;1142;3137;108;88;1557;16472
RJ;PARATI;5304;217;871;3123;57;177;1549;11298
RJ;PATY DO ALFERES;8055;529;1156;3596;85;71;1367;14859
RJ;PETROPOLIS;110332;3779;9757;25495;1013;2171;14632;167179
RJ;PINHEIRAL;5427;230;450;919;136;36;661;7859
RJ;PIRAI;6677;411;699;1040;78;53;1003;9961
RJ;PORCIUNCULA;2064;68;219;976;30;12;486;3855
RJ;PORTO REAL;7091;216;468;603;17;43;817;9255
RJ;QUATIS;2963;154;325;591;32;30;453;4548
RJ;QUEIMADOS;24608;696;1897;8182;311;86;3835;39615
RJ;QUISSAMA;4751;243;540;1560;128;53;1165;8440
RJ;RESENDE;49874;1596;4909;8662;515;730;8290;74576
RJ;RIO BONITO;29363;3283;3856;6646;140;223;7014;50525
RJ;RIO CLARO;3592;145;484;857;24;39;520;5661
RJ;RIO DAS FLORES;1746;63;208;427;26;20;242;2732
RJ;RIO DAS OSTRAS;35685;1210;3489;9484;156;588;7885;58497
RJ;RIO DE JANEIRO;2074776;43227;133486;319647;17278;41670;268641;2898725
RJ;SANTA MARIA MADALENA;2009;86;303;843;28;24;299;3592
RJ;SANTO ANTONIO DE PADUA;9106;601;1090;6813;42;74;3578;21304
RJ;SAO FIDELIS;7136;410;764;5528;79;49;3580;17546
RJ;SAO FRANCISCO DE ITABAPOANA;5958;449;915;4884;107;20;2109;14442
RJ;SAO GONCALO;223776;5452;14190;50617;2940;1092;25778;323845
RJ;SAO JOAO DA BARRA;6649;664;878;2959;88;56;2550;13844
RJ;SAO JOAO DE MERITI;109944;3725;7085;19559;1233;431;11597;153574
RJ;SAO JOSE DE UBA;1056;52;169;1525;11;1;308;3122
RJ;SAO JOSE DO VALE DO RIO PRETO;6148;766;841;2391;53;41;1156;11396
RJ;SAO PEDRO DA ALDEIA;23455;1022;2198;6686;139;202;4391;38093
RJ;SAO SEBASTIAO DO ALTO;1767;137;238;1492;8;7;360;4009
RJ;SAPUCAIA;2415;139;359;597;18;23;464;4015
RJ;SAQUAREMA;21404;908;2289;8011;161;315;4896;37984
RJ;SEROPEDICA;16529;1378;1800;3762;254;141;3415;27279
RJ;SILVA JARDIM;4051;323;516;1746;51;37;1033;7757
RJ;SUMIDOURO;3143;422;708;3057;25;29;943;8327
RJ;TANGUA;5948;411;644;1809;68;27;1062;9969
RJ;TERESOPOLIS;60959;2581;6432;18917;300;789;8498;98476
RJ;TRAJANO DE MORAIS;2024;117;323;907;26;18;299;3714
RJ;TRES RIOS;19069;1021;1935;8723;234;174;4193;35349
RJ;VALENCA;17036;405;1745;4304;108;176;2106;25880
RJ;VARRE-SAI;1505;64;237;1030;12;4;285;3137
RJ;VASSOURAS;10008;601;1208;2948;123;96;1305;16289
RJ;VOLTA REDONDA;101716;2332;7891;16810;690;1202;11067;141708
RN;ACARI;1304;120;259;1534;16;8;465;3706
RN;AFONSO BEZERRA;680;36;131;784;17;2;97;1747
RN;AGUA NOVA;215;11;45;582;2;2;113;970
RN;ALEXANDRIA;1964;151;505;2540;17;23;435;5635
RN;ALMINO AFONSO;403;25;91;795;2;2;169;1487
RN;ALTO DO RODRIGUES;1731;190;375;2154;29;24;525;5028
RN;ANGICOS;1303;131;400;1782;13;17;312;3958
RN;ANTONIO MARTINS;483;46;106;966;5;4;146;1756
RN;APODI;4002;381;949;7550;60;52;3194;16188
RN;AREIA BRANCA;2924;165;477;3074;74;49;2266;9029
RN;ARES;1127;67;163;1049;49;20;329;2804
RN;ASSU;7674;743;1508;9948;116;131;4279;24399
RN;BAIA FORMOSA;841;54;115;491;28;21;214;1764
RN;BARAUNA;2315;796;639;3223;54;41;1096;8164
RN;BARCELONA;323;26;47;384;4;1;39;824
RN;BENTO FERNANDES;448;15;51;636;16;3;44;1213
RN;BODO;259;10;66;285;5;2;43;670
RN;BOM JESUS;1011;66;180;1146;14;7;121;2545
RN;BREJINHO;1118;126;204;1865;22;6;215;3556
RN;CAICARA DO NORTE;323;20;94;494;6;4;66;1007
RN;CAICARA DO RIO DO VENTO;393;26;79;292;4;2;29;825
RN;CAICO;14930;2581;4479;14154;84;365;9399;45992
RN;CAMPO REDONDO;830;78;131;1073;16;7;223;2358
RN;CANGUARETAMA;3193;217;439;3375;94;47;1009;8374
RN;CARAUBAS;2105;177;514;3360;22;30;1083;7291
RN;CARNAUBA DOS DANTAS;1227;242;232;975;9;16;450;3151
RN;CARNAUBAIS;966;53;167;1169;15;14;268;2652
RN;CEARA-MIRIM;9173;416;1374;7035;182;158;1840;20178
RN;CERRO-CORA;1081;123;301;1609;18;10;212;3354
RN;CORONEL EZEQUIEL;457;77;61;475;5;5;58;1138
RN;CORONEL JOAO PESSOA;285;13;60;570;3;6;47;984
RN;CRUZETA;743;101;223;1264;16;2;301;2650
RN;CURRAIS NOVOS;7535;829;1466;8525;71;137;3734;22297
RN;DOUTOR SEVERIANO;357;39;105;1008;14;5;123;1651
RN;ENCANTO;395;19;73;1053;8;2;134;1684
RN;EQUADOR;693;202;169;523;5;4;176;1772
RN;ESPIRITO SANTO;690;25;108;826;24;2;85;1760
RN;EXTREMOZ;4875;114;594;3134;57;87;667;9528
RN;FELIPE GUERRA;644;54;146;1033;11;8;452;2348
RN;FERNANDO PEDROZA;251;30;39;229;2;2;58;611
RN;FLORANIA;835;83;233;1312;12;6;208;2689
RN;FRANCISCO DANTAS;242;23;64;588;4;1;117;1039
RN;FRUTUOSO GOMES;390;30;76;787;4;2;159;1448
RN;GALINHOS;160;17;35;73;4;18;21;328
RN;GOIANINHA;3289;220;430;2453;129;44;844;7409
RN;GOVERNADOR DIX-SEPT ROSADO;1093;212;190;2049;23;7;587;4161
RN;GROSSOS;766;77;129;1364;22;11;407;2776
RN;GUAMARE;1507;142;301;1812;47;28;565;4402
RN;IELMO MARINHO;740;74;152;1070;27;4;76;2143
RN;IPANGUACU;1267;124;278;1953;49;13;412;4096
RN;IPUEIRA;228;21;61;280;6;2;90;688
RN;ITAJA;668;114;122;1009;7;13;310;2243
RN;ITAU;555;44;174;829;1;7;212;1822
RN;JACANA;2319;658;464;1936;35;39;492;5943
RN;JANDAIRA;551;55;137;623;16;9;60;1451
RN;JANDUIS;341;30;73;699;4;5;116;1268
RN;JAPI;586;78;68;360;13;3;67;1175
RN;JARDIM DE ANGICOS;199;9;33;326;4;1;20;592
RN;JARDIM DE PIRANHAS;1155;139;514;2295;12;31;709;4855
RN;JARDIM DO SERIDO;1508;183;343;2408;54;8;970;5474
RN;JOAO CAMARA;3904;417;885;5560;57;92;1403;12318
RN;JOAO DIAS;159;8;41;240;1;1;46;496
RN;JOSE DA PENHA;610;39;149;1094;7;6;149;2054
RN;JUCURUTU;1416;191;534;3810;10;19;685;6665
RN;JUNDIA;234;17;60;518;10;3;45;887
RN;LAGOA DANTA;459;59;84;719;17;4;72;1414
RN;LAGOA DE PEDRAS;542;41;101;773;19;4;128;1608
RN;LAGOA DE VELHOS;275;29;23;323;4;1;48;703
RN;LAGOA NOVA;1653;125;469;1843;24;16;427;4557
RN;LAGOA SALGADA;810;137;157;1206;13;14;145;2482
RN;LAJES;900;73;189;939;12;6;224;2343
RN;LAJES PINTADAS;519;25;65;662;5;1;66;1343
RN;LUCRECIA;318;33;71;634;4;5;103;1168
RN;LUIS GOMES;1114;154;387;710;12;19;192;2588
RN;MACAIBA;9548;935;1411;9601;90;145;1941;23671
RN;MACAU;2392;198;403;4502;65;50;1266;8876
RN;MAJOR SALES;296;23;70;469;3;3;79;943
RN;MARCELINO VIEIRA;575;36;181;1058;5;7;154;2016
RN;MARTINS;660;64;201;1370;11;7;405;2718
RN;MAXARANGUAPE;889;33;188;813;12;13;96;2044
RN;MESSIAS TARGINO;329;46;111;710;4;3;149;1352
RN;MONTANHAS;1075;67;145;1589;23;6;171;3076
RN;MONTE ALEGRE;2006;151;302;2416;43;25;285;5228
RN;MONTE DAS GAMELEIRAS;195;18;40;210;12;1;26;502
RN;MOSSORO;61849;4519;9830;53217;421;2252;37557;169645
RN;NATAL;233361;7538;29326;98008;2851;11117;36980;419181
RN;NISIA FLORESTA;2686;104;440;2489;67;120;595;6501
RN;NOVA CRUZ;5064;498;853;5841;112;50;1203;13621
RN;OLHO D'AGUA DO BORGES;358;28;79;548;2;2;116;1133
RN;OURO BRANCO;494;67;119;642;7;2;143;1474
RN;PARANA;370;24;115;500;6;3;53;1071
RN;PARAU;346;16;67;499;2;2;82;1014
RN;PARAZINHO;391;31;94;454;18;2;56;1046
RN;PARELHAS;3423;624;830;3627;48;72;1421;10045
RN;PARNAMIRIM;60760;2270;6713;27694;531;2211;9677;109856
RN;PASSA E FICA;1447;206;294;1439;49;17;274;3726
RN;PASSAGEM;273;15;43;426;5;1;32;795
RN;PATU;1829;184;421;2427;9;21;608;5499
RN;PAU DOS FERROS;6385;791;1672;9050;34;163;3276;21371
RN;PEDRA GRANDE;285;16;83;406;10;0;23;823
RN;PEDRA PRETA;247;34;42;307;9;1;17;657
RN;PEDRO AVELINO;436;35;98;610;7;3;60;1249
RN;PEDRO VELHO;1185;55;142;1728;17;6;183;3316
RN;PENDENCIAS;932;74;170;2115;15;7;219;3532
RN;PILOES;290;24;52;429;2;3;47;847
RN;POCO BRANCO;870;36;138;1430;11;7;121;2613
RN;PORTALEGRE;556;48;187;1450;6;8;332;2587
RN;PORTO DO MANGUE;374;36;105;461;7;8;73;1064
RN;PUREZA;750;93;190;883;30;8;107;2061
RN;RAFAEL FERNANDES;586;63;121;1156;1;7;218;2152
RN;RAFAEL GODEIRO;290;12;43;344;4;3;75;771
RN;RIACHO DA CRUZ;245;8;48;442;1;0;55;799
RN;RIACHO DE SANTANA;323;12;77;667;5;1;122;1207
RN;RIACHUELO;630;35;96;698;7;2;71;1539
RN;RIO DO FOGO;756;48;231;868;11;17;100;2031
RN;RODOLFO FERNANDES;456;63;168;694;4;5;156;1546
RN;RUY BARBOSA;242;14;34;356;6;1;30;683
RN;SANTA CRUZ;5401;627;942;7325;50;75;3158;17578
RN;SANTA MARIA;574;71;76;535;8;4;87;1355
RN;SANTANA DO MATOS;1017;87;360;1564;13;7;173;3221
RN;SANTANA DO SERIDO;298;29;63;299;2;0;57;748
RN;SANTO ANTONIO;2573;143;467;3379;39;25;413;7039
RN;SAO BENTO DO NORTE;231;9;65;367;9;6;42;729
RN;SAO BENTO DO TRAIRI;350;15;50;461;13;2;42;933
RN;SAO FERNANDO;253;19;116;409;4;2;124;927
RN;SAO FRANCISCO DO OESTE;371;38;80;846;5;9;258;1607
RN;SAO GONCALO DO AMARANTE;12878;537;1408;9246;314;200;2066;26649
RN;SAO JOAO DO SABUGI;547;46;186;888;6;1;262;1936
RN;SAO JOSE DE MIPIBU;5674;472;925;4879;77;108;1130;13265
RN;SAO JOSE DO CAMPESTRE;811;89;130;813;22;2;134;2001
RN;SAO JOSE DO SERIDO;368;43;122;771;2;8;165;1479
RN;SAO MIGUEL;2540;288;738;5194;40;82;552;9434
RN;SAO MIGUEL DO GOSTOSO;767;32;203;1005;20;41;217;2285
RN;SAO PAULO DO POTENGI;1826;134;302;2314;31;24;382;5013
RN;SAO PEDRO;593;34;85;611;9;3;84;1419
RN;SAO RAFAEL;700;49;190;1013;6;2;145;2105
RN;SAO TOME;763;75;133;980;27;5;135;2118
RN;SAO VICENTE;617;56;152;898;7;5;192;1927
RN;SENADOR ELOI DE SOUZA;579;30;79;583;15;3;59;1348
RN;SENADOR GEORGINO AVELINO;337;17;65;356;2;4;47;828
RN;SERRA CAIADA;806;64;121;790;16;6;114;1917
RN;SERRA DE SAO BENTO;446;57;83;538;5;3;47;1179
RN;SERRA DO MEL;1410;142;511;1336;19;26;205;3649
RN;SERRA NEGRA DO NORTE;659;67;306;920;10;12;295;2269
RN;SERRINHA;693;44;109;889;11;0;108;1854
RN;SERRINHA DOS PINTOS;328;48;95;888;4;2;140;1505
RN;SEVERIANO MELO;612;46;195;1218;9;5;262;2347
RN;SITIO NOVO;338;23;61;401;3;1;53;880
RN;TABOLEIRO GRANDE;179;6;49;399;3;0;96;732
RN;TAIPU;914;60;134;1049;35;11;116;2319
RN;TANGARA;1526;152;248;1692;41;14;359;4032
RN;TENENTE ANANIAS;1091;82;741;1297;7;23;286;3527
RN;TENENTE LAURENTINO CRUZ;661;54;195;710;6;3;127;1756
RN;TIBAU;570;48;124;546;33;11;235;1567
RN;TIBAU DO SUL;1712;66;412;1234;27;133;550;4134
RN;TIMBAUBA DOS BATISTAS;189;12;54;300;7;4;66;632
RN;TOUROS;2172;189;789;3742;61;54;537;7544
RN;TRIUNFO POTIGUAR;201;18;75;430;3;2;47;776
RN;UMARIZAL;988;78;261;1806;8;19;474;3634
RN;UPANEMA;1014;109;239;1876;16;4;471;3729
RN;VARZEA;442;21;54;541;7;1;75;1141
RN;VENHA-VER;234;19;62;391;7;6;31;750
RN;VERA CRUZ;1084;195;330;1869;27;12;129;3646
RN;VICOSA;132;7;24;262;1;1;27;454
RN;VILA FLOR;273;15;26;411;2;5;52;784
RO;ALTA FLORESTA D'OESTE;2597;515;1662;7680;93;49;2168;14764
RO;ALTO ALEGRE DOS PARECIS;966;161;489;2959;47;8;509;5139
RO;ALTO PARAISO;1673;328;903;3797;79;15;1373;8168
RO;ALVORADA D'OESTE;1610;290;737;4190;76;21;1378;8302
RO;ARIQUEMES;18249;2155;7396;28263;243;288;19611;76205
RO;BURITIS;3623;560;2338;11825;57;50;3299;21752
RO;CABIXI;967;127;368;1590;29;8;468;3557
RO;CACAULANDIA;419;71;323;1072;30;6;218;2139
RO;CACOAL;18450;1862;6508;27541;349;292;15375;70377
RO;CAMPO NOVO DE RONDONIA;601;103;361;1686;66;5;404;3226
RO;CANDEIAS DO JAMARI;1936;278;633;2838;42;9;851;6587
RO;CASTANHEIRAS;367;40;149;608;18;1;118;1301
RO;CEREJEIRAS;3081;374;1283;4924;48;33;2282;12025
RO;CHUPINGUAIA;802;124;402;1527;87;7;431;3380
RO;COLORADO DO OESTE;3277;414;1353;5464;72;42;2110;12732
RO;CORUMBIARA;882;152;427;2129;25;2;431;4048
RO;COSTA MARQUES;853;239;423;2372;30;11;712;4640
RO;CUJUBIM;1102;277;662;3112;29;8;1192;6382
RO;ESPIGAO D'OESTE;3626;733;2000;8876;150;45;3562;18992
RO;GOVERNADOR JORGE TEIXEIRA;748;83;453;2548;33;2;345;4212
RO;GUAJARA-MIRIM;4101;758;1706;6873;32;60;4200;17730
RO;ITAPUA DO OESTE;856;206;377;1170;72;9;540;3230
RO;JARU;8286;1100;3119;18000;232;109;8314;39160
RO;JI-PARANA;26548;3213;9745;38511;711;404;17657;96789
RO;MACHADINHO D'OESTE;2932;424;1218;7834;65;31;2440;14944
RO;MINISTRO ANDREAZZA;948;231;506;2637;22;8;578;4930
RO;MIRANTE DA SERRA;1179;183;456;3928;33;8;999;6786
RO;MONTE NEGRO;1282;338;710;3543;98;10;1228;7209
RO;NOVA BRASILANDIA D'OESTE;1913;254;760;5403;120;20;1266;9736
RO;NOVA DO MAMORE;1925;340;1169;5103;42;9;1182;9770
RO;NOVA UNIAO;720;125;309;2003;42;5;349;3553
RO;NOVO HORIZONTE DO OESTE;1003;116;394;2462;25;5;397;4402
RO;OURO PRETO DO OESTE;6009;800;2543;13219;139;72;5098;27880
RO;PARECIS;400;98;198;971;31;3;132;1833
RO;PIMENTA BUENO;6578;1139;2448;8658;120;103;6024;25070
RO;PIMENTEIRAS DO OESTE;180;33;115;159;28;2;107;624
RO;PORTO VELHO;119093;7789;29005;90425;1881;2075;38160;288428
RO;PRESIDENTE MEDICI;2836;432;1220;4420;102;31;2681;11722
RO;PRIMAVERA DE RONDONIA;446;64;245;700;16;7;127;1605
RO;RIO CRESPO;337;58;205;446;19;2;195;1262
RO;ROLIM DE MOURA;11447;1306;3594;19708;167;150;9494;45866
RO;SANTA LUZIA D'OESTE;1007;222;431;2358;63;7;615;4703
RO;SAO FELIPE D'OESTE;691;103;295;1523;32;5;323;2972
RO;SAO FRANCISCO DO GUAPORE;1856;477;912;4360;91;10;1202;8908
RO;SAO MIGUEL DO GUAPORE;2667;336;835;5413;77;22;1684;11034
RO;SERINGUEIRAS;1212;228;461;3311;59;7;731;6009
RO;TEIXEIROPOLIS;486;70;196;1466;20;3;311;2552
RO;THEOBROMA;967;125;365;1893;27;6;416;3799
RO;URUPA;1274;155;479;4495;133;7;967;7510
RO;VALE DO ANARI;745;106;295;1816;33;6;381;3382
RO;VALE DO PARAISO;826;154;393;2165;25;4;317;3884
RO;VILHENA;21480;1610;7017;16764;194;412;17927;65404
RR;ALTO ALEGRE;517;81;286;1136;16;0;180;2216
RR;AMAJARI;200;34;126;344;4;2;65;775
RR;BOA VISTA;71637;4213;26041;66947;997;1358;27988;199181
RR;BONFIM;250;23;185;434;12;7;122;1033
RR;CANTA;420;71;197;678;16;4;185;1571
RR;CARACARAI;876;130;294;1491;12;6;585;3394
RR;CAROEBE;300;78;209;1546;32;3;313;2481
RR;IRACEMA;278;30;106;531;1;0;165;1111
RR;MUCAJAI;912;138;325;2082;48;5;614;4124
RR;NORMANDIA;136;14;86;406;2;1;63;708
RR;PACARAIMA;1022;189;283;355;11;11;148;2019
RR;RORAINOPOLIS;1279;282;525;3522;43;12;856;6519
RR;SAO JOAO DA BALIZA;286;49;152;1192;16;2;335;2032
RR;SAO LUIZ;267;56;126;1037;7;0;266;1759
RR;UIRAMUTA;7;4;19;26;0;0;4;60
RS;ACEGUA;2169;103;581;580;30;14;569;4046
RS;AGUA SANTA;1349;226;439;493;23;19;244;2793
RS;AGUDO;6062;343;1172;2016;74;44;909;10620
RS;AJURICABA;3165;500;854;834;34;41;584;6012
RS;ALECRIM;2369;112;383;1089;37;17;173;4180
RS;ALEGRETE;22484;1097;4456;7163;283;211;4162;39856
RS;ALEGRIA;1267;118;252;635;30;12;131;2445
RS;ALMIRANTE TAMANDARE DO SUL;828;144;252;261;5;9;122;1621
RS;ALPESTRE;2338;185;411;1093;62;22;400;4511
RS;ALTO ALEGRE;704;124;215;199;6;4;85;1337
RS;ALTO FELIZ;1281;131;214;476;16;12;264;2394
RS;ALVORADA;60456;1755;3410;16162;644;230;7705;90362
RS;AMARAL FERRADOR;1795;161;249;1041;27;3;255;3531
RS;AMETISTA DO SUL;2536;114;598;1548;48;42;382;5268
RS;ANDRE DA ROCHA;461;67;139;55;9;10;63;804
RS;ANTA GORDA;2861;295;529;627;22;32;614;4980
RS;ANTONIO PRADO;5973;729;1540;888;45;207;1532;10914
RS;ARAMBARE;1284;90;198;438;13;26;276;2325
RS;ARARICA;2475;118;264;686;24;21;467;4055
RS;ARATIBA;2835;211;536;855;46;23;311;4817
RS;ARROIO DO MEIO;9126;674;1278;3021;63;165;2961;17288
RS;ARROIO DO PADRE;1100;145;191;541;17;1;157;2152
RS;ARROIO DO SAL;2916;130;367;688;20;34;705;4860
RS;ARROIO DO TIGRE;4317;344;822;1513;49;65;628;7738
RS;ARROIO DOS RATOS;4787;261;564;1441;90;27;762;7932
RS;ARROIO GRANDE;6351;308;971;2636;76;34;1323;11699
RS;ARVOREZINHA;5058;567;1060;855;60;36;673;8309
RS;AUGUSTO PESTANA;3003;583;859;973;44;25;555;6042
RS;AUREA;1491;208;366;403;10;11;136;2625
RS;BAGE;43723;1559;6169;14206;406;533;7758;74354
RS;BALNEARIO PINHAL;2713;153;259;689;40;17;459;4330
RS;BARAO;2746;216;418;601;52;26;408;4467
RS;BARAO DE COTEGIPE;2687;304;634;554;22;40;468;4709
RS;BARAO DO TRIUNFO;1623;151;327;1296;76;6;147;3626
RS;BARRA DO GUARITA;616;38;79;245;8;1;102;1089
RS;BARRA DO QUARAI;1209;38;188;179;15;9;181;1819
RS;BARRA DO RIBEIRO;4211;262;498;965;63;41;742;6782
RS;BARRA DO RIO AZUL;597;44;142;260;11;3;50;1107
RS;BARRA FUNDA;1007;198;315;336;26;14;283;2179
RS;BARRACAO;2121;183;415;281;23;22;182;3227
RS;BARROS CASSAL;3299;221;622;1437;89;10;351;6029
RS;BENJAMIN CONSTANT DO SUL;517;35;81;206;16;4;33;892
RS;BENTO GONCALVES;52280;3281;7219;9355;371;1578;12646;86730
RS;BOA VISTA DAS MISSOES;817;117;213;227;14;11;214;1613
RS;BOA VISTA DO BURICA;3017;280;514;1379;33;45;657;5925
RS;BOA VISTA DO CADEADO;654;161;300;234;26;5;102;1482
RS;BOA VISTA DO INCRA;783;110;232;270;12;3;92;1502
RS;BOA VISTA DO SUL;1166;369;269;248;15;14;254;2335
RS;BOM JESUS;3486;334;862;521;74;32;412;5721
RS;BOM PRINCIPIO;6122;511;975;1408;40;93;1452;10601
RS;BOM PROGRESSO;799;59;102;412;9;5;79;1465
RS;BOM RETIRO DO SUL;5147;244;552;1760;51;37;1011;8802
RS;BOQUEIRAO DO LEAO;2498;193;410;1319;28;20;279;4747
RS;BOSSOROCA;1711;247;494;466;24;19;236;3197
RS;BOZANO;738;196;266;224;8;7;114;1553
RS;BRAGA;1148;117;164;576;24;4;164;2197
RS;BROCHIER;2185;329;265;1059;31;8;434;4311
RS;BUTIA;6849;536;689;1587;164;46;1566;11437
RS;CACAPAVA DO SUL;12706;844;2200;2845;195;87;2428;21305
RS;CACEQUI;3122;188;588;861;32;27;492;5310
RS;CACHOEIRA DO SUL;32347;1446;4452;8352;250;292;6372;53511
RS;CACHOEIRINHA;55354;2426;4382;10824;538;567;9184;83275
RS;CACIQUE DOBLE;1590;133;390;355;17;16;189;2690
RS;CAIBATE;2026;184;465;496;9;13;398;3591
RS;CAICARA;1642;108;295;1058;21;14;312;3450
RS;CAMAQUA;23940;1529;3186;9235;285;255;5487;43917
RS;CAMARGO;1283;256;345;232;21;10;211;2358
RS;CAMBARA DO SUL;1891;267;419;307;47;22;335;3288
RS;CAMPESTRE DA SERRA;1025;215;328;185;15;5;364;2137
RS;CAMPINA DAS MISSOES;2389;198;401;1102;40;20;403;4553
RS;CAMPINAS DO SUL;2464;241;555;461;24;36;403;4184
RS;CAMPO BOM;28244;892;2053;7221;93;406;6344;45253
RS;CAMPO NOVO;2081;209;387;592;35;13;362;3679
RS;CAMPOS BORGES;1474;198;374;425;21;10;224;2726
RS;CANDELARIA;10362;528;1525;4215;128;80;1679;18517
RS;CANDIDO GODOI;2744;350;587;1244;21;35;380;5361
RS;CANDIOTA;3559;210;657;958;75;43;728;6230
RS;CANELA;20691;640;2426;3190;135;408;3387;30877
RS;CANGUCU;20359;1446;2865;11903;267;85;2849;39774
RS;CANOAS;140914;4730;10051;27962;1126;1647;27513;213943
RS;CANUDOS DO VALE;512;35;103;234;8;6;105;1003
RS;CAPAO BONITO DO SUL;460;72;171;88;7;6;49;853
RS;CAPAO DA CANOA;19441;627;2237;5709;132;340;5860;34346
RS;CAPAO DO CIPO;842;156;301;449;11;10;124;1893
RS;CAPAO DO LEAO;7658;550;749;3723;41;25;1751;14497
RS;CAPELA DE SANTANA;2917;236;295;807;27;13;603;4898
RS;CAPITAO;1111;89;170;511;11;6;177;2075
RS;CAPIVARI DO SUL;1499;186;362;301;13;38;466;2865
RS;CARAA;1885;127;342;821;36;14;225;3450
RS;CARAZINHO;26072;1484;4109;6575;230;380;6498;45348
RS;CARLOS BARBOSA;12755;923;2048;2285;156;339;2891;21397
RS;CARLOS GOMES;499;52;95;155;9;1;42;853
RS;CASCA;4725;497;1043;652;36;116;1011;8080
RS;CASEIROS;1319;198;369;249;18;6;170;2329
RS;CATUIPE;3660;510;850;1258;46;36;529;6889
RS;CAXIAS DO SUL;216559;9297;25119;34624;1771;5299;39437;332106
RS;CENTENARIO;1122;145;283;284;11;6;103;1954
RS;CERRITO;1783;241;267;986;25;8;410;3720
RS;CERRO BRANCO;1373;79;225;640;22;8;189;2536
RS;CERRO GRANDE;863;57;136;425;12;6;100;1599
RS;CERRO GRANDE DO SUL;3482;324;551;2944;34;14;400;7749
RS;CERRO LARGO;5686;417;984;1877;47;92;1479;10582
RS;CHAPADA;4712;479;992;1352;40;35;1000;8610
RS;CHARQUEADAS;12271;443;1030;2991;134;90;2243;19202
RS;CHARRUA;862;117;214;229;11;6;85;1524
RS;CHIAPETTA;1603;180;349;328;16;14;272;2762
RS;CHUI;4298;133;464;418;6;121;941;6381
RS;CHUVISCA;1673;152;273;791;40;8;195;3132
RS;CIDREIRA;3456;121;367;991;39;24;616;5614
RS;CIRIACO;2406;193;396;521;25;18;261;3820
RS;COLINAS;1125;76;158;352;12;9;302;2034
RS;COLORADO;1522;289;590;348;14;9;242;3014
RS;CONDOR;2849;342;677;594;40;38;441;4981
RS;CONSTANTINA;4752;490;819;978;87;70;622;7818
RS;COQUEIRO BAIXO;481;28;105;143;3;6;82;848
RS;COQUEIROS DO SUL;918;163;255;360;10;4;85;1795
RS;CORONEL BARROS;1046;164;272;272;9;8;162;1933
RS;CORONEL BICACO;2630;290;476;700;30;18;371;4515
RS;CORONEL PILAR;518;237;167;87;8;13;76;1106
RS;COTIPORA;1630;298;491;313;18;29;213;2992
RS;COXILHA;1237;164;337;206;16;16;307;2283
RS;CRISSIUMAL;5127;359;786;3237;52;66;792;10419
RS;CRISTAL;2578;262;379;867;68;14;562;4730
RS;CRISTAL DO SUL;833;64;116;490;20;4;108;1635
RS;CRUZ ALTA;23618;1339;3997;6939;162;333;4369;40757
RS;CRUZALTENSE;742;86;184;293;11;7;76;1399
RS;CRUZEIRO DO SUL;5439;584;731;1875;21;80;1688;10418
RS;DAVID CANABARRO;2146;198;470;624;27;21;266;3752
RS;DERRUBADAS;805;141;146;507;18;6;83;1706
RS;DEZESSEIS DE NOVEMBRO;766;67;170;414;9;2;131;1559
RS;DILERMANDO DE AGUIAR;639;53;173;240;33;2;95;1235
RS;DOIS IRMAOS;13599;513;1227;2198;109;326;2391;20363
RS;DOIS IRMAOS DAS MISSOES;705;94;170;204;7;6;98;1284
RS;DOIS LAJEADOS;1551;157;268;251;19;22;193;2461
RS;DOM FELICIANO;4443;261;674;2318;101;23;361;8181
RS;DOM PEDRITO;12398;736;3001;5231;65;224;3620;25275
RS;DOM PEDRO DE ALCANTARA;732;127;145;431;7;3;158;1603
RS;DONA FRANCISCA;1009;62;192;454;8;3;107;1835
RS;DOUTOR MAURICIO CARDOSO;1993;246;380;698;18;19;293;3647
RS;DOUTOR RICARDO;877;76;165;212;8;6;119;1463
RS;ELDORADO DO SUL;12250;987;1204;3412;77;133;2426;20489
RS;ENCANTADO;10040;749;1534;2765;144;179;2687;18098
RS;ENCRUZILHADA DO SUL;8187;517;1408;2799;234;48;1424;14617
RS;ENGENHO VELHO;438;49;89;109;14;5;48;752
RS;ENTRE IJUIS;4040;485;858;1109;29;32;844;7397
RS;ENTRE RIOS DO SUL;971;73;171;161;18;10;153;1557
RS;EREBANGO;1191;142;227;220;5;10;126;1921
RS;ERECHIM;47941;2259;7380;10306;568;1198;11461;81113
RS;ERNESTINA;1437;189;390;379;19;13;343;2770
RS;ERVAL GRANDE;1308;165;392;565;35;18;247;2730
RS;ERVAL SECO;2581;198;425;820;41;7;216;4288
RS;ESMERALDA;1220;117;314;127;17;10;109;1914
RS;ESPERANCA DO SUL;884;70;106;521;19;3;95;1698
RS;ESPUMOSO;7044;872;1766;1766;93;81;1486;13108
RS;ESTACAO;2865;254;555;400;31;51;529;4685
RS;ESTANCIA VELHA;20802;925;1647;4791;127;284;4025;32601
RS;ESTEIO;31478;1091;2228;5358;270;327;6282;47034
RS;ESTRELA;14602;1173;1711;3815;73;308;4969;26651
RS;ESTRELA VELHA;1201;163;306;373;27;7;187;2264
RS;EUGENIO DE CASTRO;1089;127;286;262;18;3;181;1966
RS;FAGUNDES VARELA;1155;131;304;262;18;14;173;2057
RS;FARROUPILHA;32551;2444;4107;4667;257;849;6258;51133
RS;FAXINAL DO SOTURNO;2530;185;585;745;17;26;347;4435
RS;FAXINALZINHO;732;65;159;167;13;2;114;1252
RS;FAZENDA VILANOVA;1670;152;253;615;30;8;279;3007
RS;FELIZ;6163;488;987;1612;95;96;1450;10891
RS;FLORES DA CUNHA;14601;1698;2788;1954;152;466;3786;25445
RS;FLORIANO PEIXOTO;745;85;167;278;22;1;59;1357
RS;FONTOURA XAVIER;3770;254;548;934;59;12;521;6098
RS;FORMIGUEIRO;2090;207;423;723;25;7;279;3754
RS;FORQUETINHA;806;72;148;415;6;10;203;1660
RS;FORTALEZA DOS VALOS;1773;307;656;421;26;15;270;3468
RS;FREDERICO WESTPHALEN;13183;919;2238;3845;105;255;3194;23739
RS;GARIBALDI;15748;1630;2696;2645;149;468;4675;28011
RS;GARRUCHOS;587;61;140;300;18;1;79;1186
RS;GAURAMA;2622;251;567;680;20;36;374;4550
RS;GENERAL CAMARA;2481;129;293;784;35;9;458;4189
RS;GENTIL;650;123;213;181;21;8;79;1275
RS;GETULIO VARGAS;7916;546;1288;1298;56;170;1750;13024
RS;GIRUA;6566;653;1367;1367;55;54;1294;11356
RS;GLORINHA;3108;303;486;700;16;43;600;5256
RS;GRAMADO;19366;730;2586;2954;164;689;3888;30377
RS;GRAMADO DOS LOUREIROS;646;48;126;118;14;1;55;1008
RS;GRAMADO XAVIER;1050;84;200;692;10;6;96;2138
RS;GRAVATAI;112276;3759;8692;22074;751;1110;18481;167143
RS;GUABIJU;611;59;184;79;12;10;86;1041
RS;GUAIBA;36736;1248;3041;7746;431;312;6336;55850
RS;GUAPORE;12256;552;1882;1418;88;276;1751;18223
RS;GUARANI DAS MISSOES;3070;335;586;855;39;10;654;5549
RS;HARMONIA;2243;271;351;617;9;12;439;3942
RS;HERVAL;2179;134;437;770;19;12;370;3921
RS;HERVEIRAS;782;69;121;349;3;3;52;1379
RS;HORIZONTINA;8865;447;1397;2520;67;157;2911;16364
RS;HULHA NEGRA;1523;105;248;672;27;0;181;2756
RS;HUMAITA;1923;188;367;717;15;35;276;3521
RS;IBARAMA;1499;111;280;602;20;9;136;2657
RS;IBIACA;2005;313;676;368;34;46;282;3724
RS;IBIRAIARAS;2983;548;983;673;36;58;561;5842
RS;IBIRAPUITA;1748;160;292;349;56;7;133;2745
RS;IBIRUBA;9813;1132;2508;1623;109;123;1923;17231
RS;IGREJINHA;14432;591;1517;4177;71;263;3409;24460
RS;IJUI;34324;2018;5845;9799;138;600;8360;61084
RS;ILOPOLIS;1809;256;538;280;17;29;279;3208
RS;IMBE;8407;338;850;1961;81;91;2006;13734
RS;IMIGRANTE;1246;111;201;366;20;19;269;2232
RS;INDEPENDENCIA;2768;331;585;768;56;24;374;4906
RS;INHACORA;737;87;137;228;9;4;61;1263
RS;IPE;2496;352;817;402;34;40;386;4527
RS;IPIRANGA DO SUL;852;152;284;235;12;13;162;1710
RS;IRAI;2531;172;362;1021;22;15;520;4643
RS;ITAARA;1838;145;323;465;21;20;315;3127
RS;ITACURUBI;806;73;161;345;12;1;81;1479
RS;ITAPUCA;763;81;140;186;13;1;63;1247
RS;ITAQUI;9951;740;1799;3970;111;122;2817;19510
RS;ITATI;732;77;158;345;10;5;199;1526
RS;ITATIBA DO SUL;1066;87;223;463;13;5;111;1968
RS;IVORA;634;86;216;185;8;6;67;1202
RS;IVOTI;10470;606;1001;1839;119;258;2153;16446
RS;JABOTICABA;1226;106;241;667;32;8;172;2452
RS;JACUIZINHO;666;81;184;299;19;1;71;1321
RS;JACUTINGA;1674;148;430;301;9;18;182;2762
RS;JAGUARAO;11955;371;1710;2934;73;147;2667;19857
RS;JAGUARI;3795;355;1026;1286;61;26;564;7113
RS;JAQUIRANA;1284;177;289;158;18;12;137;2075
RS;JARI;931;118;243;539;18;9;87;1945
RS;JOIA;2725;411;666;1107;55;24;444;5432
RS;JULIO DE CASTILHOS;6534;767;1936;1453;84;90;1693;12557
RS;LAGOA BONITA DO SUL;890;75;168;299;16;3;51;1502
RS;LAGOA DOS TRES CANTOS;670;118;246;183;7;1;152;1377
RS;LAGOA VERMELHA;12443;752;2669;1651;88;213;1535;19351
RS;LAGOAO;1506;113;283;820;50;10;123;2905
RS;LAJEADO;40026;2386;4937;9729;285;1249;12950;71562
RS;LAJEADO DO BUGRE;706;38;71;313;14;0;64;1206
RS;LAVRAS DO SUL;2181;127;514;620;33;16;297;3788
RS;LIBERATO SALZANO;1612;167;286;726;34;14;217;3056
RS;LINDOLFO COLLOR;2401;149;191;500;21;21;380;3663
RS;LINHA NOVA;681;92;123;205;4;7;124;1236
RS;MACAMBARA;664;56;169;256;43;5;132;1325
RS;MACHADINHO;1989;162;410;581;30;11;303;3486
RS;MAMPITUBA;277;30;81;339;12;2;35;776
RS;MANOEL VIANA;2120;206;510;546;15;20;479;3896
RS;MAQUINE;2434;286;390;799;20;25;501;4455
RS;MARATA;997;143;172;445;22;8;224;2011
RS;MARAU;19498;1240;3608;3211;216;355;4164;32292
RS;MARCELINO RAMOS;1674;144;306;444;35;15;258;2876
RS;MARIANA PIMENTEL;1506;174;208;645;34;5;165;2737
RS;MARIANO MORO;919;82;175;168;20;3;147;1514
RS;MARQUES DE SOUZA;1375;134;266;590;18;18;376;2777
RS;MATA;1519;133;324;594;30;10;253;2863
RS;MATO CASTELHANO;865;165;299;318;20;8;168;1843
RS;MATO LEITAO;1855;168;254;753;14;19;639;3702
RS;MATO QUEIMADO;643;113;160;293;8;3;177;1397
RS;MAXIMILIANO DE ALMEIDA;2071;185;373;444;56;25;433;3587
RS;MINAS DO LEAO;2723;127;300;456;38;11;376;4031
RS;MIRAGUAI;1744;130;237;915;37;5;298;3366
RS;MONTAURI;685;87;218;114;5;15;137;1261
RS;MONTE ALEGRE DOS CAMPOS;702;131;227;323;28;3;68;1482
RS;MONTE BELO DO SUL;1075;315;266;238;25;12;195;2126
RS;MONTENEGRO;27570;1550;2703;7919;193;330;7138;47403
RS;MORMACO;987;109;224;258;14;4;93;1689
RS;MORRINHOS DO SUL;920;183;137;734;6;1;258;2239
RS;MORRO REDONDO;2658;266;454;1599;27;25;571;5600
RS;MORRO REUTER;2734;225;404;519;29;63;500;4474
RS;MOSTARDAS;3728;369;666;940;80;78;750;6611
RS;MUCUM;2229;103;327;494;21;34;428;3636
RS;MUITOS CAPOES;724;123;305;169;9;11;158;1499
RS;MULITERNO;645;124;186;200;12;6;86;1259
RS;NAO-ME-TOQUE;7795;616;1606;1878;83;173;2003;14154
RS;NICOLAU VERGUEIRO;750;119;188;212;19;10;104;1402
RS;NONOAI;4324;269;769;771;58;49;621;6861
RS;NOVA ALVORADA;1476;223;329;277;18;23;143;2489
RS;NOVA ARACA;2108;160;438;324;42;36;312;3420
RS;NOVA BASSANO;4393;532;1059;893;59;82;922;7940
RS;NOVA BOA VISTA;924;113;184;378;12;1;121;1733
RS;NOVA BRESCIA;1307;161;266;433;19;26;218;2430
RS;NOVA CANDELARIA;1115;103;198;734;11;18;257;2436
RS;NOVA ESPERANCA DO SUL;1704;115;430;612;47;8;190;3106
RS;NOVA HARTZ;7483;204;660;1868;137;80;1425;11857
RS;NOVA PADUA;983;366;290;201;5;23;126;1994
RS;NOVA PALMA;2026;345;813;817;42;27;428;4498
RS;NOVA PETROPOLIS;10699;589;1331;1725;73;284;2142;16843
RS;NOVA PRATA;12918;733;2321;1760;84;303;1990;20109
RS;NOVA RAMADA;865;160;266;345;12;8;116;1772
RS;NOVA ROMA DO SUL;1261;363;362;169;26;24;140;2345
RS;NOVA SANTA RITA;10755;1057;1197;2283;65;92;3415;18864
RS;NOVO BARREIRO;1469;194;276;589;17;3;236;2784
RS;NOVO CABRAIS;1162;125;262;467;10;17;187;2230
RS;NOVO HAMBURGO;113167;3392;8592;26354;490;2316;21719;176030
RS;NOVO MACHADO;1345;213;250;528;19;11;175;2541
RS;NOVO TIRADENTES;627;57;101;296;10;3;81;1175
RS;NOVO XINGU;546;65;93;167;10;0;57;938
RS;OSORIO;21529;989;2365;4190;117;303;4574;34067
RS;PAIM FILHO;1550;160;373;352;32;11;174;2652
RS;PALMARES DO SUL;3914;209;567;996;53;49;820;6608
RS;PALMEIRA DAS MISSOES;14110;1167;2528;3152;116;141;3527;24741
RS;PALMITINHO;2705;244;483;1602;51;43;549;5677
RS;PANAMBI;20087;1178;3308;4525;150;270;3200;32718
RS;PANTANO GRANDE;3283;355;545;589;36;29;774;5611
RS;PARAI;3092;575;982;689;17;77;655;6087
RS;PARAISO DO SUL;2284;117;434;859;26;12;238;3970
RS;PARECI NOVO;1891;461;349;453;19;23;513;3709
RS;PAROBE;21056;707;1843;6161;209;142;3824;33942
RS;PASSA SETE;1556;119;346;679;34;13;102;2849
RS;PASSO DO SOBRADO;2109;168;415;1075;60;16;386;4229
RS;PASSO FUNDO;85750;3894;11311;18518;410;1839;16368;138090
RS;PAULO BENTO;740;110;199;255;10;7;110;1431
RS;PAVERAMA;2946;242;360;1402;54;14;549;5567
RS;PEDRAS ALTAS;571;30;103;213;8;10;147;1082
RS;PEDRO OSORIO;2676;146;363;1038;37;22;501;4783
RS;PEJUCARA;1546;270;485;360;24;14;227;2926
RS;PELOTAS;126936;6004;13406;46183;1291;1721;27867;223408
RS;PICADA CAFE;2416;113;287;493;60;40;445;3854
RS;PINHAL;829;132;184;397;11;9;147;1709
RS;PINHAL DA SERRA;676;81;167;154;21;1;77;1177
RS;PINHAL GRANDE;1219;168;380;408;31;8;167;2381
RS;PINHEIRINHO DO VALE;1055;71;178;829;25;10;183;2351
RS;PINHEIRO MACHADO;4629;187;792;1059;63;25;662;7417
RS;PINTO BANDEIRA;688;203;235;94;7;25;170;1422
RS;PIRAPO;704;64;157;418;16;2;79;1440
RS;PIRATINI;6038;336;952;2349;157;30;794;10656
RS;PLANALTO;3694;264;632;1016;36;37;463;6142
RS;POCO DAS ANTAS;873;123;195;361;16;12;135;1715
RS;PONTAO;1320;196;307;306;29;8;145;2311
RS;PONTE PRETA;651;84;179;288;9;8;106;1325
RS;PORTAO;17577;1864;1836;2785;131;223;3422;27838
RS;PORTO ALEGRE;610617;15969;46449;97712;5209;17446;96542;889944
RS;PORTO LUCENA;1734;117;269;614;18;8;260;3020
RS;PORTO MAUA;785;74;188;297;12;4;127;1487
RS;PORTO VERA CRUZ;484;22;124;225;10;3;70;938
RS;PORTO XAVIER;3518;229;728;1140;58;36;1421;7130
RS;POUSO NOVO;671;52;139;175;12;7;152;1208
RS;PRESIDENTE LUCENA;1266;213;185;284;22;13;239;2222
RS;PROGRESSO;2123;141;381;792;41;19;197;3694
RS;PROTASIO ALVES;858;54;210;157;9;9;88;1385
RS;PUTINGA;1665;145;306;627;9;12;151;2915
RS;QUARAI;13814;246;2193;3000;65;90;1686;21094
RS;QUATRO IRMAOS;530;70;113;125;9;5;70;922
RS;QUEVEDOS;796;63;242;401;16;8;76;1602
RS;QUINZE DE NOVEMBRO;1718;267;406;318;34;10;251;3004
RS;REDENTORA;1736;150;279;701;22;6;176;3070
RS;RELVADO;858;61;159;221;6;13;95;1413
RS;RESTINGA SECA;5279;387;1023;1379;74;33;736;8911
RS;RIO DOS INDIOS;759;106;193;324;33;6;42;1463
RS;RIO GRANDE;72769;2549;6527;28885;764;702;17289;129485
RS;RIO PARDO;11287;559;1490;3961;128;56;1903;19384
RS;RIOZINHO;1482;60;237;495;36;16;260;2586
RS;ROCA SALES;3695;185;416;1452;45;44;815;6652
RS;RODEIO BONITO;2847;213;543;834;41;58;571;5107
RS;ROLADOR;699;74;177;339;6;4;89;1388
RS;ROLANTE;7664;327;1004;3200;107;121;1400;13823
RS;RONDA ALTA;3682;383;868;577;37;71;626;6244
RS;RONDINHA;2069;209;402;360;22;22;227;3311
RS;ROQUE GONZALES;2133;176;466;943;31;10;536;4295
RS;ROSARIO DO SUL;11734;629;2132;4269;119;121;2254;21258
RS;SAGRADA FAMILIA;799;43;121;331;10;5;100;1409
RS;SALDANHA MARINHO;1174;192;363;172;9;11;223;2144
RS;SALTO DO JACUI;4008;245;710;739;33;25;651;6411
RS;SALVADOR DAS MISSOES;1144;144;321;465;10;20;264;2368
RS;SALVADOR DO SUL;3142;334;469;919;32;38;564;5498
RS;SANANDUVA;7768;753;1882;1708;87;137;1420;13755
RS;SANTA BARBARA DO SUL;3476;425;948;510;34;46;866;6305
RS;SANTA CECILIA DO SUL;562;94;152;226;16;6;56;1112
RS;SANTA CLARA DO SUL;2700;140;306;1037;17;51;617;4868
RS;SANTA CRUZ DO SUL;57306;2376;6315;15792;692;1145;13843;97469
RS;SANTA MARGARIDA DO SUL;514;76;142;168;17;2;97;1016
RS;SANTA MARIA;102360;4013;13598;26393;1096;1777;20834;170071
RS;SANTA MARIA DO HERVAL;2806;282;327;664;62;43;462;4646
RS;SANTA ROSA;33084;1854;4826;9438;228;566;8107;58103
RS;SANTA TEREZA;600;119;121;83;5;4;88;1020
RS;SANTA VITORIA DO PALMAR;12638;736;1735;4499;87;275;3542;23512
RS;SANTANA DA BOA VISTA;2982;138;510;1169;63;13;267;5142
RS;SANTANA DO LIVRAMENTO;41673;981;5609;13699;260;365;6521;69108
RS;SANTIAGO;18457;1103;4350;5384;114;191;3600;33199
RS;SANTO ANGELO;30583;1419;4483;9320;135;466;6458;52864
RS;SANTO ANTONIO DA PATRULHA;17339;1055;2280;4751;220;165;3203;29013
RS;SANTO ANTONIO DAS MISSOES;3392;284;712;1117;58;19;469;6051
RS;SANTO ANTONIO DO PALMA;897;76;194;195;14;4;53;1433
RS;SANTO ANTONIO DO PLANALTO;941;113;214;260;11;3;102;1644
RS;SANTO AUGUSTO;5904;610;1285;1112;39;80;933;9963
RS;SANTO CRISTO;6628;640;1268;2417;56;82;1156;12247
RS;SANTO EXPEDITO DO SUL;991;122;249;408;13;8;102;1893
RS;SAO BORJA;20413;1337;4055;6661;124;193;4160;36943
RS;SAO DOMINGOS DO SUL;1354;128;320;300;14;14;166;2296
RS;SAO FRANCISCO DE ASSIS;5973;428;1288;1371;132;38;839;10069
RS;SAO FRANCISCO DE PAULA;7755;675;1260;1257;104;102;1230;12383
RS;SAO GABRIEL;18609;994;3430;5800;161;188;3610;32792
RS;SAO JERONIMO;6911;355;697;1687;132;64;1027;10873
RS;SAO JOAO DA URTIGA;1975;189;436;628;24;9;235;3496
RS;SAO JOAO DO POLESINE;999;110;307;215;6;11;176;1824
RS;SAO JORGE;1092;160;386;247;21;21;180;2107
RS;SAO JOSE DAS MISSOES;778;52;136;312;9;4;57;1348
RS;SAO JOSE DO HERVAL;767;75;138;135;14;3;193;1325
RS;SAO JOSE DO HORTENCIO;1962;222;288;469;34;18;329;3322
RS;SAO JOSE DO INHACORA;853;74;140;441;10;18;144;1680
RS;SAO JOSE DO NORTE;6099;480;917;2935;159;56;1183;11829
RS;SAO JOSE DO OURO;3261;406;904;497;47;45;857;6017
RS;SAO JOSE DO SUL;923;163;166;339;18;6;207;1822
RS;SAO JOSE DOS AUSENTES;786;145;302;148;26;12;108;1527
RS;SAO LEOPOLDO;83460;2776;6049;18952;432;1109;16214;128992
RS;SAO LOURENCO DO SUL;15789;1151;2073;6261;187;82;2701;28244
RS;SAO LUIZ GONZAGA;12693;751;2669;4258;108;126;2987;23592
RS;SAO MARCOS;10255;861;2004;1635;143;178;3508;18584
RS;SAO MARTINHO;2449;276;446;850;23;30;446;4520
RS;SAO MARTINHO DA SERRA;883;75;224;385;7;6;133;1713
RS;SAO MIGUEL DAS MISSOES;2778;328;687;932;50;30;524;5329
RS;SAO NICOLAU;1465;87;316;559;19;7;158;2611
RS;SAO PAULO DAS MISSOES;2198;148;333;1009;37;23;289;4037
RS;SAO PEDRO DA SERRA;1708;117;296;452;17;12;314;2916
RS;SAO PEDRO DAS MISSOES;622;48;126;249;9;0;64;1118
RS;SAO PEDRO DO BUTIA;1218;162;225;484;19;11;264;2383
RS;SAO PEDRO DO SUL;6006;380;1240;1566;59;45;983;10279
RS;SAO SEBASTIAO DO CAI;9793;793;1051;1833;64;110;2102;15746
RS;SAO SEPE;8212;547;1532;2062;132;31;1657;14173
RS;SAO VALENTIM;1297;86;286;232;15;9;141;2066
RS;SAO VALENTIM DO SUL;1021;92;218;201;13;12;123;1680
RS;SAO VALERIO DO SUL;536;53;84;130;9;0;45;857
RS;SAO VENDELINO;1071;83;221;254;16;27;239;1911
RS;SAO VICENTE DO SUL;2667;168;590;763;59;20;502;4769
RS;SAPIRANGA;32270;1014;2507;9491;201;421;6580;52484
RS;SAPUCAIA DO SUL;58431;1792;3465;13275;155;321;10185;87624
RS;SARANDI;9353;675;1651;1732;89;138;1733;15371
RS;SEBERI;4543;368;807;1695;67;56;864;8400
RS;SEDE NOVA;983;129;196;407;13;11;171;1910
RS;SEGREDO;2161;231;427;1096;54;12;182;4163
RS;SELBACH;2419;373;712;438;28;23;477;4470
RS;SENADOR SALGADO FILHO;1071;180;251;335;14;2;121;1974
RS;SENTINELA DO SUL;1618;202;297;1019;20;1;304;3461
RS;SERAFINA CORREA;7388;445;1321;1033;87;152;1322;11748
RS;SERIO;737;69;117;316;6;5;70;1320
RS;SERTAO;2821;323;654;557;43;19;447;4864
RS;SERTAO SANTANA;2350;188;369;1238;28;10;321;4504
RS;SETE DE SETEMBRO;604;116;166;222;12;3;83;1206
RS;SEVERIANO DE ALMEIDA;1557;124;381;483;16;19;196;2776
RS;SILVEIRA MARTINS;828;140;263;243;9;9;180;1672
RS;SINIMBU;2672;149;332;1515;7;18;283;4976
RS;SOBRADINHO;5627;352;984;1310;68;102;828;9271
RS;SOLEDADE;11932;715;2060;2036;156;178;1836;18913
RS;TABAI;1982;220;261;684;22;6;351;3526
RS;TAPEJARA;10207;954;2166;2560;136;214;2208;18445
RS;TAPERA;4159;450;932;885;39;69;901;7435
RS;TAPES;5340;311;601;1484;39;64;1008;8847
RS;TAQUARA;22425;944;2239;6338;288;403;4205;36842
RS;TAQUARI;10104;491;1140;4013;165;77;3055;19045
RS;TAQUARUCU DO SUL;1119;90;232;500;15;10;215;2181
RS;TAVARES;1794;172;325;560;30;21;329;3231
RS;TENENTE PORTELA;4708;367;789;1805;80;64;772;8585
RS;TERRA DE AREIA;4179;363;621;990;46;38;958;7195
RS;TEUTONIA;14567;810;1767;4155;116;165;3082;24662
RS;TIO HUGO;1276;156;299;281;19;16;301;2348
RS;TIRADENTES DO SUL;1576;143;274;1070;13;3;215;3294
RS;TOROPI;1000;78;232;534;21;0;102;1967
RS;TORRES;13424;528;1503;3831;118;234;3561;23199
RS;TRAMANDAI;17126;743;1795;4667;191;205;4355;29082
RS;TRAVESSEIRO;741;48;106;460;13;10;182;1560
RS;TRES ARROIOS;1082;135;283;469;5;10;179;2163
RS;TRES CACHOEIRAS;4101;687;684;1078;32;71;1760;8413
RS;TRES COROAS;9093;308;994;3150;87;161;2267;16060
RS;TRES DE MAIO;10288;846;1775;3018;90;194;2778;18989
RS;TRES FORQUILHAS;813;106;194;463;7;2;269;1854
RS;TRES PALMEIRAS;1576;100;276;438;28;11;184;2613
RS;TRES PASSOS;11377;606;1662;4142;142;158;2347;20434
RS;TRINDADE DO SUL;2242;168;387;555;29;16;235;3632
RS;TRIUNFO;9311;676;1240;2176;271;58;2343;16075
RS;TUCUNDUVA;2559;306;478;477;17;34;500;4371
RS;TUNAS;1076;86;228;574;27;1;73;2065
RS;TUPANCI DO SUL;628;83;144;176;19;4;53;1107
RS;TUPANCIRETA;6461;777;1868;1909;88;133;1431;12667
RS;TUPANDI;2052;125;328;711;48;17;642;3923
RS;TUPARENDI;3948;373;866;1202;35;39;774;7237
RS;TURUCU;1165;130;195;576;15;5;313;2399
RS;UBIRETAMA;804;123;135;395;5;5;106;1573
RS;UNIAO DA SERRA;598;69;119;126;8;6;51;977
RS;UNISTALDA;649;70;192;236;19;2;99;1267
RS;URUGUAIANA;36905;2075;5503;13708;192;469;11254;70106
RS;VACARIA;26400;1966;5171;3691;644;325;6031;44228
RS;VALE DO SOL;3370;208;458;1266;55;8;436;5801
RS;VALE REAL;2343;226;361;449;12;23;605;4019
RS;VALE VERDE;970;76;182;444;14;5;189;1880
RS;VANINI;891;102;216;210;18;8;121;1566
RS;VENANCIO AIRES;27200;1317;2963;11319;239;290;7006;50334
RS;VERA CRUZ;10440;532;1309;3598;155;81;1983;18098
RS;VERANOPOLIS;11143;973;2301;1758;73;301;2491;19040
RS;VESPASIANO CORREA;822;136;164;246;13;4;123;1508
RS;VIADUTOS;2006;176;414;489;24;14;239;3362
RS;VIAMAO;90152;2432;7619;20063;728;790;12165;133949
RS;VICENTE DUTRA;1232;77;216;899;21;6;164;2615
RS;VICTOR GRAEFF;1304;196;387;428;9;12;252;2588
RS;VILA FLORES;1742;203;381;349;22;28;234;2959
RS;VILA LANGARO;674;140;288;322;17;8;87;1536
RS;VILA MARIA;1935;355;534;195;47;23;397;3486
RS;VILA NOVA DO SUL;1590;152;275;358;17;3;207;2602
RS;VISTA ALEGRE;946;92;178;555;12;4;116;1903
RS;VISTA ALEGRE DO PRATA;700;48;148;146;5;4;87;1138
RS;VISTA GAUCHA;897;94;148;458;14;6;187;1804
RS;VITORIA DAS MISSOES;1185;156;265;457;19;2;131;2215
RS;WESTFALIA;1332;167;224;390;19;17;241;2390
RS;XANGRI-LA;5864;237;851;1603;21;145;2052;10773
SC;ABDON BATISTA;991;84;266;336;14;1;77;1769
SC;ABELARDO LUZ;6144;434;1360;1791;137;132;1245;11243
SC;AGROLANDIA;4341;288;763;1532;22;55;1222;8223
SC;AGRONOMICA;2183;167;457;688;11;25;608;4139
SC;AGUA DOCE;2812;270;660;619;38;40;808;5247
SC;AGUAS DE CHAPECO;2199;78;371;970;32;16;381;4047
SC;AGUAS FRIAS;915;75;201;398;7;27;540;2163
SC;AGUAS MORNAS;2544;330;515;1024;17;67;563;5060
SC;ALFREDO WAGNER;3457;348;642;2161;22;41;725;7396
SC;ALTO BELA VISTA;948;68;198;271;10;12;106;1613
SC;ANCHIETA;2409;210;511;800;25;31;372;4358
SC;ANGELINA;1885;254;448;1366;24;21;411;4409
SC;ANITA GARIBALDI;3284;156;610;1034;36;28;343;5491
SC;ANITAPOLIS;1173;164;277;750;17;21;193;2595
SC;ANTONIO CARLOS;3641;729;890;1569;20;117;1246;8212
SC;APIUNA;4019;216;606;991;25;44;720;6621
SC;ARABUTA;1647;158;375;588;34;12;334;3148
SC;ARAQUARI;9790;974;1379;2638;82;219;3734;18816
SC;ARARANGUA;31918;1438;3799;10041;171;606;10709;58682
SC;ARMAZEM;3769;302;625;1520;19;78;1402;7715
SC;ARROIO TRINTA;1628;200;461;492;27;28;571;3407
SC;ARVOREDO;781;72;182;340;12;5;128;1520
SC;ASCURRA;4128;267;622;868;45;70;724;6724
SC;ATALANTA;1528;103;260;617;9;11;275;2803
SC;AURORA;2482;224;535;733;21;26;1076;5097
SC;BALNEARIO ARROIO DO SILVA;4415;145;549;1261;16;65;955;7406
SC;BALNEARIO BARRA DO SUL;3354;192;439;656;14;41;750;5446
SC;BALNEARIO CAMBORIU;52254;916;5997;15816;278;3820;18012;97093
SC;BALNEARIO DE PICARRAS;8642;337;1132;2460;66;177;2516;15330
SC;BALNEARIO GAIVOTA;4796;246;597;1228;34;90;1142;8133
SC;BALNEARIO RINCAO;3675;112;416;803;12;88;746;5852
SC;BANDEIRANTE;977;65;187;565;18;6;173;1991
SC;BARRA BONITA;590;43;129;390;10;6;76;1244
SC;BARRA VELHA;12134;656;1587;3412;66;206;3692;21753
SC;BELA VISTA DO TOLDO;1851;113;379;1118;42;7;229;3739
SC;BELMONTE;1019;84;198;413;6;10;237;1967
SC;BENEDITO NOVO;4502;344;889;2324;33;65;1458;9615
SC;BIGUACU;26197;1536;3014;9729;143;305;6330;47254
SC;BLUMENAU;176671;5768;17874;42095;946;4896;31925;280175
SC;BOCAINA DO SUL;1098;82;277;403;18;8;137;2023
SC;BOM JARDIM DA SERRA;1275;181;374;343;25;20;173;2391
SC;BOM JESUS;1061;87;230;293;11;9;367;2058
SC;BOM JESUS DO OESTE;831;77;139;256;10;8;109;1430
SC;BOM RETIRO;3397;238;611;951;39;36;431;5703
SC;BOMBINHAS;7780;227;1333;2445;42;458;2601;14886
SC;BOTUVERA;2129;233;504;1037;15;64;743;4725
SC;BRACO DO NORTE;15583;1250;2702;4423;89;476;4045;28568
SC;BRACO DO TROMBUDO;1516;144;308;523;10;20;451;2972
SC;BRUNOPOLIS;840;127;263;333;12;2;72;1649
SC;BRUSQUE;62800;2819;8989;19036;221;1816;16142;111823
SC;CACADOR;34033;2204;5448;5519;712;478;6131;54525
SC;CAIBI;2401;185;457;720;20;55;1063;4901
SC;CALMON;944;46;169;274;27;5;98;1563
SC;CAMBORIU;28748;1269;3594;15280;48;469;12792;62200
SC;CAMPO ALEGRE;4795;458;983;2000;19;91;1038;9384
SC;CAMPO BELO DO SUL;2452;244;619;427;53;19;225;4039
SC;CAMPO ERE;4024;364;781;1087;37;85;726;7104
SC;CAMPOS NOVOS;16188;1181;3290;2389;122;224;2905;26299
SC;CANELINHA;3645;542;585;1404;11;47;1476;7710
SC;CANOINHAS;22780;1368;3835;6731;195;370;4670;39949
SC;CAPAO ALTO;892;85;244;138;21;4;123;1507
SC;CAPINZAL;10351;544;1794;3308;66;165;2376;18604
SC;CAPIVARI DE BAIXO;9839;392;942;3660;28;158;3789;18808
SC;CATANDUVAS;4495;443;826;613;46;82;1284;7789
SC;CAXAMBU DO SUL;1442;137;357;743;14;15;244;2952
SC;CELSO RAMOS;1109;87;267;313;8;9;295;2088
SC;CERRO NEGRO;1142;71;247;260;21;1;69;1811
SC;CHAPADAO DO LAGEADO;1123;65;181;681;12;2;175;2239
SC;CHAPECO;101556;4804;15674;28194;470;3006;30401;184105
SC;COCAL DO SUL;8051;349;1104;2438;31;227;1782;13982
SC;CONCORDIA;35115;2966;6307;11133;269;788;14193;70771
SC;CORDILHEIRA ALTA;1764;350;451;527;25;28;593;3738
SC;CORONEL FREITAS;3883;323;952;1336;31;50;911;7486
SC;CORONEL MARTINS;871;53;140;381;9;1;59;1514
SC;CORREIA PINTO;6600;465;1125;1145;83;28;932;10378
SC;CORUPA;5908;480;1192;2719;36;93;1528;11956
SC;CRICIUMA;98471;3576;10314;25801;440;3497;19847;161946
SC;CUNHA PORA;4873;443;785;1556;73;91;1326;9147
SC;CUNHATAI;797;57;123;324;10;4;118;1433
SC;CURITIBANOS;18848;1119;3146;3180;163;193;2536;29185
SC;DESCANSO;3598;246;783;1320;36;42;1109;7134
SC;DIONISIO CERQUEIRA;5638;198;932;1386;16;136;1124;9430
SC;DONA EMMA;1637;142;251;663;13;19;288;3013
SC;DOUTOR PEDRINHO;1502;150;299;623;8;13;388;2983
SC;ENTRE RIOS;1002;33;146;531;30;2;77;1821
SC;ERMO;1010;103;178;585;10;18;812;2716
SC;ERVAL VELHO;1760;136;421;643;27;10;301;3298
SC;FAXINAL DOS GUEDES;4687;436;915;1062;46;59;1155;8360
SC;FLOR DO SERTAO;570;26;96;337;16;3;96;1144
SC;FLORIANOPOLIS;230367;3872;20711;50326;1977;11119;45450;363822
SC;FORMOSA DO SUL;910;67;212;369;19;6;189;1772
SC;FORQUILHINHA;11929;626;1509;5523;41;156;2483;22267
SC;FRAIBURGO;15948;968;2373;2712;242;205;2311;24759
SC;FREI ROGERIO;863;100;284;383;20;3;87;1740
SC;GALVAO;1225;121;273;359;14;13;114;2119
SC;GAROPABA;9530;328;1715;3610;61;582;3075;18901
SC;GARUVA;6274;629;919;1660;55;93;1741;11371
SC;GASPAR;27935;1489;4282;8512;82;761;6630;49691
SC;GOVERNADOR CELSO RAMOS;4971;214;725;1570;19;128;1470;9097
SC;GRAO PARA;2809;288;549;972;21;64;413;5116
SC;GRAVATAL;4793;347;697;2300;21;100;1378;9636
SC;GUABIRUBA;9881;358;1521;3428;27;275;2590;18080
SC;GUARACIABA;4392;281;943;1116;41;67;793;7633
SC;GUARAMIRIM;17555;1152;2333;5892;27;272;4618;31849
SC;GUARUJA DO SUL;2003;177;401;668;26;23;445;3743
SC;GUATAMBU;2200;176;489;1076;27;28;440;4436
SC;HERVAL D'OESTE;8738;410;1151;2813;69;85;2178;15444
SC;IBIAM;731;78;167;303;14;1;116;1410
SC;IBICARE;1473;173;308;489;10;7;550;3010
SC;IBIRAMA;8943;499;1292;2898;98;145;2231;16106
SC;ICARA;26474;1979;3303;9096;164;645;6902;48563
SC;ILHOTA;5320;420;742;1998;32;75;1354;9941
SC;IMARUI;3617;180;536;1930;34;43;855;7195
SC;IMBITUBA;18949;791;2314;7341;105;551;5735;35786
SC;IMBUIA;2580;204;463;815;21;26;603;4712
SC;INDAIAL;31014;1685;3849;8495;140;596;6831;52610
SC;IOMERE;1154;178;352;305;9;24;267;2289
SC;IPIRA;2100;138;372;674;21;8;371;3684
SC;IPORA DO OESTE;3547;306;696;1540;49;63;1111;7312
SC;IPUACU;1758;134;365;655;45;26;293;3276
SC;IPUMIRIM;2895;304;585;1093;32;15;779;5703
SC;IRACEMINHA;1544;132;347;516;24;9;264;2836
SC;IRANI;4223;418;826;700;70;54;643;6934
SC;IRATI;709;51;137;376;8;3;131;1415
SC;IRINEOPOLIS;3613;311;847;1471;19;30;465;6756
SC;ITA;2717;121;593;772;45;42;649;4939
SC;ITAIOPOLIS;8207;717;1586;3190;109;79;1082;14970
SC;ITAJAI;90971;4846;10289;31165;421;2119;40781;180592
SC;ITAPEMA;25044;701;3506;7527;60;1561;7669;46068
SC;ITAPIRANGA;6630;410;1133;3369;87;106;1989;13724
SC;ITAPOA;6370;327;1062;2095;30;202;1968;12054
SC;ITUPORANGA;12231;782;2050;3035;77;277;3137;21589
SC;JABORA;1651;157;380;373;27;16;284;2888
SC;JACINTO MACHADO;3956;471;861;2286;44;64;1146;8828
SC;JAGUARUNA;8119;518;1327;2961;84;219;2163;15391
SC;JARAGUA DO SUL;75855;2765;8744;19044;461;1936;16966;125771
SC;JARDINOPOLIS;688;29;115;269;8;5;97;1211
SC;JOACABA;14156;870;2448;3680;51;395;3741;25341
SC;JOINVILLE;273386;8460;23708;61157;908;5591;53555;426765
SC;JOSE BOITEUX;1898;129;302;745;12;12;339;3437
SC;JUPIA;778;59;207;335;11;6;150;1546
SC;LACERDOPOLIS;968;135;248;297;8;14;300;1970
SC;LAGEADO GRANDE;564;45;148;192;4;1;93;1047
SC;LAGES;75932;3651;10167;14418;407;1104;13633;119312
SC;LAGUNA;16503;568;1805;6021;97;366;4078;29438
SC;LAURENTINO;3028;338;686;891;9;44;910;5906
SC;LAURO MULLER;6623;480;904;2757;53;102;3776;14695
SC;LEBON REGIS;3835;296;661;720;72;27;407;6018
SC;LEOBERTO LEAL;1099;131;257;743;5;20;178;2433
SC;LINDOIA DO SUL;1730;145;372;580;44;14;315;3200
SC;LONTRAS;4812;383;858;1676;42;66;1242;9079
SC;LUIZ ALVES;5189;508;1178;2230;29;64;1478;10676
SC;LUZERNA;2765;162;545;800;24;48;799;5143
SC;MACIEIRA;633;109;170;163;14;4;58;1151
SC;MAFRA;23470;1513;4079;7566;162;367;5057;42214
SC;MAJOR GERCINO;1174;139;256;557;10;8;278;2422
SC;MAJOR VIEIRA;2277;226;559;1340;18;14;349;4783
SC;MARACAJA;3149;263;408;1316;17;34;1081;6268
SC;MARAVILHA;11289;904;2064;3243;90;251;4337;22178
SC;MAREMA;802;68;234;214;9;3;113;1443
SC;MASSARANDUBA;6304;618;1307;2859;41;96;1744;12969
SC;MATOS COSTA;966;76;202;253;21;5;104;1627
SC;MELEIRO;2973;271;666;1286;24;76;770;6066
SC;MIRIM DOCE;1026;85;187;444;13;11;207;1973
SC;MODELO;1764;140;258;480;10;33;294;2979
SC;MONDAI;3780;199;526;2292;63;54;1329;8243
SC;MONTE CARLO;3234;189;430;458;105;15;514;4945
SC;MONTE CASTELO;2585;201;424;792;29;15;377;4423
SC;MORRO DA FUMACA;8442;879;1129;4367;47;168;3297;18329
SC;MORRO GRANDE;1079;151;200;575;12;19;318;2354
SC;NAVEGANTES;24009;986;2627;11709;77;336;10321;50065
SC;NOVA ERECHIM;1855;151;377;530;13;27;363;3316
SC;NOVA ITABERABA;1554;121;384;884;15;19;238;3215
SC;NOVA TRENTO;5606;315;1060;2074;43;86;1853;11037
SC;NOVA VENEZA;5822;464;1111;2280;45;126;1523;11371
SC;NOVO HORIZONTE;861;72;198;315;18;7;127;1598
SC;ORLEANS;9862;955;1771;3526;56;301;3793;20264
SC;OTACILIO COSTA;7830;546;1362;1215;70;70;1927;13020
SC;OURO;3009;261;690;889;32;41;763;5685
SC;OURO VERDE;704;96;227;358;7;8;133;1533
SC;PAIAL;514;26;113;222;10;2;78;965
SC;PAINEL;695;47;199;143;10;5;66;1165
SC;PALHOCA;71641;2781;7877;23661;411;1208;16407;123986
SC;PALMA SOLA;2769;228;565;883;37;31;471;4984
SC;PALMEIRA;936;131;199;239;6;7;268;1786
SC;PALMITOS;6608;449;1216;2474;71;96;2397;13311
SC;PAPANDUVA;6624;578;1344;2530;103;71;1122;12372
SC;PARAISO;1479;114;263;714;14;11;181;2776
SC;PASSO DE TORRES;5492;192;920;1414;30;239;1633;9920
SC;PASSOS MAIA;1444;136;353;388;61;13;218;2613
SC;PAULO LOPES;2775;270;459;1348;56;59;901;5868
SC;PEDRAS GRANDES;1616;258;327;1164;18;16;548;3947
SC;PENHA;10445;439;1408;3739;63;169;3646;19909
SC;PERITIBA;1361;115;273;351;16;13;256;2385
SC;PESCARIA BRAVA;2101;152;342;1020;8;29;751;4403
SC;PETROLANDIA;2575;205;471;1001;25;36;613;4926
SC;PINHALZINHO;8883;568;1535;2114;68;186;2256;15610
SC;PINHEIRO PRETO;1369;331;384;350;15;19;397;2865
SC;PIRATUBA;2433;126;439;624;34;49;497;4202
SC;PLANALTO ALEGRE;1083;82;213;471;8;5;193;2055
SC;POMERODE;15708;682;2106;4458;92;373;3820;27239
SC;PONTE ALTA;1674;162;292;268;17;9;242;2664
SC;PONTE ALTA DO NORTE;1100;111;224;150;11;7;220;1823
SC;PONTE SERRADA;4445;368;856;564;126;44;804;7207
SC;PORTO BELO;8382;331;1335;2595;39;253;2599;15534
SC;PORTO UNIAO;15522;785;2732;4080;47;470;3257;26893
SC;POUSO REDONDO;6931;537;1228;1922;49;111;1483;12261
SC;PRAIA GRANDE;3487;286;637;2440;30;50;730;7660
SC;PRESIDENTE CASTELO BRANCO;774;84;163;242;8;3;112;1386
SC;PRESIDENTE GETULIO;7384;397;1158;2482;61;132;1951;13565
SC;PRESIDENTE NEREU;772;48;171;472;8;12;129;1612
SC;PRINCESA;978;71;176;561;13;8;188;1995
SC;QUILOMBO;4206;252;800;1601;55;51;943;7908
SC;RANCHO QUEIMADO;1237;171;335;569;8;31;286;2637
SC;RIO DAS ANTAS;2202;211;478;556;37;17;268;3769
SC;RIO DO CAMPO;2635;204;492;1050;20;49;440;4890
SC;RIO DO OESTE;2969;231;555;1165;23;59;588;5590
SC;RIO DO SUL;32512;1465;4810;7170;122;1054;8551;55684
SC;RIO DOS CEDROS;4727;306;893;1918;38;73;986;8941
SC;RIO FORTUNA;2148;293;569;1044;19;63;566;4702
SC;RIO NEGRINHO;17663;1150;2702;5128;115;257;5277;32292
SC;RIO RUFINO;829;63;158;346;22;9;70;1497
SC;RIQUEZA;1752;153;307;831;31;16;297;3387
SC;RODEIO;5587;307;936;1613;30;90;1305;9868
SC;ROMELANDIA;1717;106;325;1001;31;9;197;3386
SC;SALETE;3571;205;618;1478;26;47;820;6765
SC;SALTINHO;1238;72;210;710;27;3;143;2403
SC;SALTO VELOSO;1851;177;532;463;10;20;309;3362
SC;SANGAO;4411;505;636;2161;19;110;2058;9900
SC;SANTA CECILIA;6393;544;1169;907;76;63;1004;10156
SC;SANTA HELENA;959;72;199;463;15;8;172;1888
SC;SANTA ROSA DE LIMA;936;139;245;567;12;9;202;2110
SC;SANTA ROSA DO SUL;3575;311;516;1360;32;46;1010;6850
SC;SANTA TEREZINHA;2388;218;547;1294;32;25;244;4748
SC;SANTA TEREZINHA DO PROGRESSO;753;54;117;464;19;1;89;1497
SC;SANTIAGO DO SUL;519;74;127;253;5;8;118;1104
SC;SANTO AMARO DA IMPERATRIZ;10343;723;1767;3789;79;281;2772;19754
SC;SAO BENTO DO SUL;37493;1768;5664;9306;205;992;7765;63193
SC;SAO BERNARDINO;898;62;147;472;24;8;106;1717
SC;SAO BONIFACIO;1215;154;294;696;11;22;210;2602
SC;SAO CARLOS;4460;242;778;1478;55;60;990;8063
SC;SAO CRISTOVAO DO SUL;1642;310;323;187;17;6;235;2720
SC;SAO DOMINGOS;3720;388;866;1018;69;56;917;7034
SC;SAO FRANCISCO DO SUL;17032;799;2152;5881;94;246;5812;32016
SC;SAO JOAO BATISTA;13036;647;1609;4116;63;163;4230;23864
SC;SAO JOAO DO ITAPERIU;1481;276;321;793;13;17;480;3381
SC;SAO JOAO DO OESTE;2602;201;518;1293;25;35;610;5284
SC;SAO JOAO DO SUL;3201;247;561;1829;22;28;802;6690
SC;SAO JOAQUIM;10546;1210;2617;1715;263;144;1063;17558
SC;SAO JOSE;103260;3584;11632;32108;239;2019;19886;172728
SC;SAO JOSE DO CEDRO;5687;441;1181;1917;71;74;1514;10885
SC;SAO JOSE DO CERRITO;2540;255;630;707;67;9;198;4406
SC;SAO LOURENCO D'OESTE;11607;903;1920;3256;104;242;2916;20948
SC;SAO LUDGERO;5366;683;896;1973;29;164;1418;10529
SC;SAO MARTINHO;1618;165;264;784;6;22;313;3172
SC;SAO MIGUEL D'OESTE;20163;1140;3815;5565;128;486;5897;37194
SC;SAO MIGUEL DA BOA VISTA;614;33;117;298;9;3;99;1173
SC;SAO PEDRO DE ALCANTARA;1575;158;351;670;6;29;311;3100
SC;SAUDADES;3799;285;602;1485;46;41;666;6924
SC;SCHROEDER;6892;270;908;2438;31;106;1743;12388
SC;SEARA;7863;422;1368;1944;122;70;1833;13622
SC;SERRA ALTA;1175;72;242;415;16;11;281;2212
SC;SIDEROPOLIS;5699;444;876;1864;74;111;1379;10447
SC;SOMBRIO;14016;860;1579;3887;99;210;3938;24589
SC;SUL BRASIL;1006;66;149;483;15;5;123;1847
SC;TAIO;8321;641;1558;2931;74;168;1927;15620
SC;TANGARA;3398;446;816;1053;59;44;675;6491
SC;TIGRINHOS;689;34;127;378;13;3;172;1416
SC;TIJUCAS;15978;1134;2167;5272;71;283;6865;31770
SC;TIMBE DO SUL;1884;178;414;1163;23;27;401;4090
SC;TIMBO;20200;781;2701;4975;56;535;4836;34084
SC;TIMBO GRANDE;2211;207;436;747;37;8;264;3910
SC;TRES BARRAS;6595;335;881;1896;78;72;1920;11777
SC;TREVISO;1522;122;307;686;8;22;375;3042
SC;TREZE DE MAIO;3043;426;517;1906;26;47;1097;7062
SC;TREZE TILIAS;3555;374;961;747;55;95;1105;6892
SC;TROMBUDO CENTRAL;3176;250;572;858;28;33;808;5725
SC;TUBARAO;49081;2506;6230;18114;318;1927;18807;96983
SC;TUNAPOLIS;1807;110;342;959;25;19;317;3579
SC;TURVO;5450;532;1117;2112;46;179;1739;11175
SC;UNIAO DO OESTE;1177;65;207;599;19;4;156;2227
SC;URUBICI;3798;298;922;1375;54;72;730;7249
SC;URUPEMA;790;88;246;161;10;7;75;1377
SC;URUSSANGA;9620;541;1517;4145;87;250;2501;18661
SC;VARGEAO;1297;174;307;305;15;29;466;2593
SC;VARGEM;918;72;174;270;17;4;83;1538
SC;VARGEM BONITA;2058;205;383;298;23;11;277;3255
SC;VIDAL RAMOS;2502;198;516;1212;18;24;481;4951
SC;VIDEIRA;24581;1868;4484;6752;176;504;6994;45359
SC;VITOR MEIRELES;1862;107;313;876;24;12;275;3469
SC;WITMARSUM;1630;136;316;687;15;17;362;3163
SC;XANXERE;21485;1378;4241;4486;135;559;7428;39712
SC;XAVANTINA;1251;134;451;364;11;15;178;2404
SC;XAXIM;11721;818;2179;2994;163;205;4333;22413
SC;ZORTEA;1145;50;235;301;8;6;133;1878
SE;AMPARO DE SAO FRANCISCO;145;9;27;253;3;3;61;501
SE;AQUIDABA;1549;135;242;2807;56;15;534;5338
SE;ARACAJU;177004;5973;20387;64590;2552;4249;42543;317298
SE;ARAUA;870;52;108;1047;26;4;210;2317
SE;AREIA BRANCA;1705;170;247;1728;23;8;573;4454
SE;BARRA DOS COQUEIROS;4146;90;413;1965;50;63;1245;7972
SE;BOQUIM;2551;220;337;3970;59;20;1690;8847
SE;BREJO GRANDE;207;8;44;395;15;1;68;738
SE;CAMPO DO BRITO;1891;551;383;2861;83;16;1225;7010
SE;CANHOBA;188;8;34;501;7;0;26;764
SE;CANINDE DE SAO FRANCISCO;2048;208;491;3419;32;9;624;6831
SE;CAPELA;2507;149;262;2832;72;9;1149;6980
SE;CARIRA;2090;310;415;3616;117;5;627;7180
SE;CARMOPOLIS;1933;110;245;986;30;12;836;4152
SE;CEDRO DE SAO JOAO;581;22;93;577;5;3;271;1552
SE;CRISTINAPOLIS;1191;114;171;1680;45;9;447;3657
SE;CUMBE;365;31;50;466;15;1;115;1043
SE;DIVINA PASTORA;391;9;36;192;10;0;67;705
SE;ESTANCIA;8870;590;1334;7961;326;92;6206;25379
SE;FEIRA NOVA;455;21;35;641;8;1;132;1293
SE;FREI PAULO;1504;155;313;1502;41;3;666;4184
SE;GARARU;515;53;106;1262;32;0;114;2082
SE;GENERAL MAYNARD;371;13;27;205;11;1;138;766
SE;GRACCHO CARDOSO;424;22;45;854;10;3;87;1445
SE;ILHA DAS FLORES;393;18;45;568;15;2;113;1154
SE;INDIAROBA;1066;40;131;801;24;3;418;2483
SE;ITABAIANA;14698;3439;3160;21317;214;224;15910;58962
SE;ITABAIANINHA;2896;592;507;5726;82;22;1026;10851
SE;ITABI;425;26;55;788;9;2;93;1398
SE;ITAPORANGA D'AJUDA;2848;335;415;2778;85;12;1254;7727
SE;JAPARATUBA;1936;67;213;1246;81;8;467;4018
SE;JAPOATA;894;62;201;1109;49;6;200;2521
SE;LAGARTO;13227;1188;2567;20395;268;130;9596;47371
SE;LARANJEIRAS;2796;137;244;1861;41;27;1222;6328
SE;MACAMBIRA;502;58;81;1123;22;0;277;2063
SE;MALHADA DOS BOIS;343;24;49;277;13;1;145;852
SE;MALHADOR;1051;222;337;1361;61;3;389;3424
SE;MARUIM;1775;46;148;665;41;7;556;3238
SE;MOITA BONITA;1175;512;242;1624;21;3;802;4379
SE;MONTE ALEGRE DE SERGIPE;1081;170;181;1731;50;1;261;3475
SE;MURIBECA;632;39;69;590;40;2;140;1512
SE;NEOPOLIS;1308;54;179;2049;36;8;612;4246
SE;NOSSA SENHORA APARECIDA;758;152;126;1161;22;2;240;2461
SE;NOSSA SENHORA DA GLORIA;4251;549;885;7379;246;44;2050;15404
SE;NOSSA SENHORA DAS DORES;2563;254;432;3727;159;13;1271;8419
SE;NOSSA SENHORA DE LOURDES;385;29;75;824;13;6;89;1421
SE;NOSSA SENHORA DO SOCORRO;24128;1114;1860;15509;244;89;6789;49733
SE;PACATUBA;782;419;130;1330;62;3;144;2870
SE;PEDRA MOLE;182;9;36;283;7;1;40;558
SE;PEDRINHAS;577;68;96;1273;13;4;245;2276
SE;PINHAO;470;22;62;715;11;2;182;1464
SE;PIRAMBU;676;33;116;643;27;3;245;1743
SE;POCO REDONDO;1281;182;313;3367;74;14;327;5558
SE;POCO VERDE;2290;138;412;2878;129;14;572;6433
SE;PORTO DA FOLHA;1419;140;331;2885;40;5;325;5145
SE;PROPRIA;3170;258;536;5360;67;26;2013;11430
SE;RIACHAO DO DANTAS;1065;34;184;1699;21;1;276;3280
SE;RIACHUELO;749;43;70;404;10;3;173;1452
SE;RIBEIROPOLIS;2054;284;453;2761;77;18;1495;7142
SE;ROSARIO DO CATETE;1079;46;86;568;18;3;345;2145
SE;SALGADO;1853;145;348;2453;157;7;730;5693
SE;SANTA LUZIA DO ITANHY;732;30;70;644;32;2;296;1806
SE;SANTA ROSA DE LIMA;332;25;48;307;10;0;72;794
SE;SANTANA DO SAO FRANCISCO;235;13;43;600;11;1;112;1015
SE;SANTO AMARO DAS BROTAS;1134;24;118;687;20;7;352;2342
SE;SAO CRISTOVAO;12355;462;1373;7478;324;60;3494;25546
SE;SAO DOMINGOS;835;159;128;1268;27;4;429;2850
SE;SAO FRANCISCO;339;25;49;245;29;1;100;788
SE;SAO MIGUEL DO ALEIXO;253;45;51;439;7;0;96;891
SE;SIMAO DIAS;4447;283;811;8177;334;25;1724;15801
SE;SIRIRI;703;36;92;478;138;1;143;1591
SE;TELHA;282;20;32;436;7;0;103;880
SE;TOBIAS BARRETO;4745;373;912;9533;280;60;2314;18217
SE;TOMAR DO GERU;777;61;121;1464;19;1;125;2568
SE;UMBAUBA;2498;321;407;3570;49;17;1298;8160
SP;ADAMANTINA;15280;754;2524;4602;88;164;4489;27901
SP;ADOLFO;1450;65;223;370;28;9;331;2476
SP;AGUAI;11562;966;1571;4790;220;94;2868;22071
SP;AGUAS DA PRATA;2884;132;473;819;15;46;458;4827
SP;AGUAS DE LINDOIA;7799;201;983;3126;104;133;1257;13603
SP;AGUAS DE SANTA BARBARA;2565;143;427;563;36;19;520;4273
SP;AGUAS DE SAO PEDRO;1784;43;237;280;6;35;318;2703
SP;AGUDOS;13191;589;1625;3838;120;91;2848;22302
SP;ALAMBARI;1315;102;238;646;9;9;247;2566
SP;ALFREDO MARCONDES;1497;76;304;402;8;3;184;2474
SP;ALTAIR;1102;72;152;164;37;5;111;1643
SP;ALTINOPOLIS;6452;420;1055;816;126;105;1211;10185
SP;ALTO ALEGRE;1323;104;318;433;44;5;291;2518
SP;ALUMINIO;6229;258;540;1155;56;22;628;8888
SP;ALVARES FLORENCE;1153;58;226;321;18;3;231;2010
SP;ALVARES MACHADO;8563;522;1412;3590;35;77;1566;15765
SP;ALVARO DE CARVALHO;957;37;107;209;28;1;87;1426
SP;ALVINLANDIA;959;50;158;199;16;3;124;1509
SP;AMERICANA;115848;3479;14736;27679;577;2133;19792;184244
SP;AMERICO BRASILIENSE;14141;715;1497;5331;220;58;3406;25368
SP;AMERICO DE CAMPOS;2273;134;397;570;36;3;382;3795
SP;AMPARO;30366;1460;4060;13215;154;412;5880;55547
SP;ANALANDIA;1615;96;214;314;18;5;366;2628
SP;ANDRADINA;23076;1217;3487;9983;179;246;8213;46401
SP;ANGATUBA;7508;433;1253;2696;126;67;1514;13597
SP;ANHEMBI;1552;108;261;224;31;8;233;2417
SP;ANHUMAS;1197;81;260;336;9;6;161;2050
SP;APARECIDA;12905;765;1732;4222;539;229;2385;22777
SP;APARECIDA D'OESTE;1925;122;326;510;33;8;346;3270
SP;APIAI;6034;419;961;3110;104;47;995;11670
SP;ARACARIGUAMA;6300;558;909;1814;59;87;1038;10765
SP;ARACATUBA;83216;3628;11337;45192;842;1272;29795;175282
SP;ARACOIABA DA SERRA;12679;596;1811;4496;35;191;1920;21728
SP;ARAMINA;2111;94;334;222;30;11;342;3144
SP;ARANDU;1649;74;248;494;31;8;229;2733
SP;ARAPEI;699;45;93;206;11;7;77;1138
SP;ARARAQUARA;107966;3974;12423;38124;1199;1256;20328;185270
SP;ARARAS;56673;2429;6789;21560;386;661;14974;103472
SP;ARCO-IRIS;505;75;106;189;11;3;87;976
SP;AREALVA;2431;200;625;741;36;21;463;4517
SP;AREIAS;1014;57;141;298;8;10;85;1613
SP;AREIOPOLIS;3447;178;375;588;156;18;604;5366
SP;ARIRANHA;3294;275;574;704;184;11;918;5960
SP;ARTUR NOGUEIRA;22001;1105;3157;7863;191;198;3854;38369
SP;ARUJA;35611;2899;4944;6386;417;708;6295;57260
SP;ASPASIA;641;22;119;213;5;1;124;1125
SP;ASSIS;41756;2003;6448;19010;408;522;10695;80842
SP;ATIBAIA;68612;2626;9166;22825;367;1396;11350;116342
SP;AURIFLAMA;5772;377;1036;2263;61;66;1396;10971
SP;AVAI;1216;95;200;259;28;7;285;2090
SP;AVANHANDAVA;3250;184;435;1197;75;22;876;6039
SP;AVARE;37602;1479;5165;12435;297;577;8160;65715
SP;BADY BASSITT;7614;408;1287;2134;70;55;1760;13328
SP;BALBINOS;503;25;72;89;7;1;69;766
SP;BALSAMO;3688;239;699;896;25;42;804;6393
SP;BANANAL;2895;210;439;756;41;55;393;4789
SP;BARAO DE ANTONINA;786;34;154;253;14;2;82;1325
SP;BARBOSA;1888;121;235;656;46;3;333;3282
SP;BARIRI;13907;906;2196;4682;99;91;3342;25223
SP;BARRA BONITA;17025;1024;2181;4709;257;189;3759;29144
SP;BARRA DO CHAPEU;913;69;225;892;20;8;119;2246
SP;BARRA DO TURVO;976;79;150;406;62;1;185;1859
SP;BARRETOS;48729;2272;6785;24504;539;725;13120;96674
SP;BARRINHA;8648;520;1004;2797;220;56;2358;15603
SP;BARUERI;113737;6178;13685;24876;1267;3888;20039;183670
SP;BASTOS;8660;969;1421;3163;119;90;2623;17045
SP;BATATAIS;24927;1267;3855;7469;203;306;4931;42958
SP;BAURU;178207;6203;21058;49970;1367;2023;30113;288941
SP;BEBEDOURO;32424;1772;4714;12892;344;420;12965;65531
SP;BENTO DE ABREU;888;64;108;222;15;1;171;1469
SP;BERNARDINO DE CAMPOS;4287;394;783;882;44;39;784;7213
SP;BERTIOGA;13514;541;2033;6198;103;220;3459;26068
SP;BILAC;3053;171;508;1118;24;16;615;5505
SP;BIRIGUI;47088;1942;6299;25738;183;557;20598;102405
SP;BIRITIBA-MIRIM;8852;473;1032;1757;50;64;1083;13311
SP;BOA ESPERANCA DO SUL;4957;355;723;700;118;14;841;7708
SP;BOCAINA;4466;192;712;1017;43;34;961;7425
SP;BOFETE;3488;239;638;725;58;18;509;5675
SP;BOITUVA;26974;1787;3729;6198;157;350;6669;45864
SP;BOM JESUS DOS PERDOES;9327;593;1169;3078;70;84;1342;15663
SP;BOM SUCESSO DE ITARARE;837;86;168;384;16;2;118;1611
SP;BORA;256;43;60;79;9;2;80;529
SP;BORACEIA;1479;212;321;316;21;5;407;2761
SP;BORBOREMA;5878;430;1107;1603;119;41;1528;10706
SP;BOREBI;744;54;136;195;7;2;133;1271
SP;BOTUCATU;64029;1907;7933;17320;475;876;11616;104156
SP;BRAGANCA PAULISTA;74596;3093;9965;28839;405;1371;13335;131604
SP;BRAUNA;1676;84;384;428;86;11;333;3002
SP;BREJO ALEGRE;632;165;98;219;19;2;376;1511
SP;BRODOWSKI;9496;670;1950;1954;66;120;1854;16110
SP;BROTAS;9588;542;1647;2225;222;128;2784;17136
SP;BURI;5346;542;926;1882;108;59;1082;9945
SP;BURITAMA;5743;384;976;2297;83;46;2156;11685
SP;BURITIZAL;1538;125;342;427;35;11;445;2923
SP;CABRALIA PAULISTA;1485;146;215;397;19;3;278;2543
SP;CABREUVA;18366;1043;2286;5469;69;170;2332;29735
SP;CACAPAVA;37241;1277;3580;10008;170;425;5296;57997
SP;CACHOEIRA PAULISTA;10290;410;1135;2962;34;124;1582;16537
SP;CACONDE;6715;296;1109;1503;77;44;638;10382
SP;CAFELANDIA;6431;322;856;1547;90;43;1281;10570
SP;CAIABU;1301;41;193;296;42;3;129;2005
SP;CAIEIRAS;31199;1080;3438;6094;445;391;3975;46622
SP;CAIUA;992;60;183;354;25;3;231;1848
SP;CAJAMAR;28543;1638;3587;5992;380;337;3909;44386
SP;CAJATI;7289;687;1050;3598;230;54;2035;14943
SP;CAJOBI;3566;260;613;546;106;18;566;5675
SP;CAJURU;9565;544;1740;1764;129;67;1881;15690
SP;CAMPINA DO MONTE ALEGRE;1679;100;255;509;35;6;234;2818
SP;CAMPINAS;618367;20392;64717;119751;5748;10389;77756;917120
SP;CAMPO LIMPO PAULISTA;31513;726;3076;8217;65;264;3500;47361
SP;CAMPOS DO JORDAO;22062;698;2751;7287;68;444;2623;35933
SP;CAMPOS NOVOS PAULISTA;1260;123;273;444;47;8;228;2383
SP;CANANEIA;1983;110;358;857;17;44;527;3896
SP;CANAS;1113;152;150;349;9;6;162;1941
SP;CANDIDO MOTA;11388;1084;2063;3392;83;88;2606;20704
SP;CANDIDO RODRIGUES;1160;122;206;213;14;4;165;1884
SP;CANITAR;1295;56;118;279;22;1;227;1998
SP;CAPAO BONITO;13197;1028;2066;5424;220;108;4218;26261
SP;CAPELA DO ALTO;6640;608;1063;2723;47;31;1120;12232
SP;CAPIVARI;21907;1201;3037;6151;321;266;4181;37064
SP;CARAGUATATUBA;38357;1669;4805;16843;138;638;7713;70163
SP;CARAPICUIBA;132139;4041;11483;36632;999;1065;15674;202033
SP;CARDOSO;4395;214;740;1003;59;18;991;7420
SP;CASA BRANCA;10721;617;1727;4339;117;135;1814;19470
SP;CASSIA DOS COQUEIROS;999;29;217;179;17;6;89;1536
SP;CASTILHO;5409;259;784;1897;120;24;1286;9779
SP;CATANDUVA;56428;2905;7731;26962;510;679;14375;109590
SP;CATIGUA;2552;81;285;509;33;6;511;3977
SP;CEDRAL;3667;245;663;938;26;30;711;6280
SP;CERQUEIRA CESAR;7434;431;1129;1750;165;52;1428;12389
SP;CERQUILHO;18777;968;2692;5389;121;191;3465;31603
SP;CESARIO LANGE;7588;381;864;2407;77;47;928;12292
SP;CHARQUEADA;5757;446;896;1352;98;47;1042;9638
SP;CHAVANTES;3899;146;454;693;65;30;608;5895
SP;CLEMENTINA;2631;317;367;844;64;7;1076;5306
SP;COLINA;6434;399;929;2587;96;65;1880;12390
SP;COLOMBIA;1973;154;310;452;73;7;393;3362
SP;CONCHAL;10197;871;1779;3597;306;95;2235;19080
SP;CONCHAS;6602;381;1093;1729;49;54;879;10787
SP;CORDEIROPOLIS;10214;777;1383;2939;63;110;2137;17623
SP;COROADOS;1754;121;272;594;24;10;387;3162
SP;CORONEL MACEDO;1095;75;184;308;25;5;148;1840
SP;CORUMBATAI;1508;172;302;402;14;19;439;2856
SP;COSMOPOLIS;24163;874;2683;7742;226;177;4346;40211
SP;COSMORAMA;3111;230;610;974;50;20;631;5626
SP;COTIA;97814;3253;10849;20505;847;2147;13142;148557
SP;CRAVINHOS;13325;978;2101;3366;181;171;3227;23349
SP;CRISTAIS PAULISTA;2519;153;467;661;33;34;375;4242
SP;CRUZALIA;814;82;160;222;5;5;130;1418
SP;CRUZEIRO;25762;794;2377;9654;61;332;4271;43251
SP;CUBATAO;29512;2819;2506;10322;401;251;12069;57880
SP;CUNHA;6643;383;1104;4200;49;79;628;13086
SP;DESCALVADO;14004;1130;2102;4541;199;124;3060;25160
SP;DIADEMA;135092;4450;11580;43481;649;961;21556;217769
SP;DIRCE REIS;486;74;90;216;8;2;87;963
SP;DIVINOLANDIA;4938;477;1207;1182;69;69;534;8476
SP;DOBRADA;2379;80;244;763;92;5;367;3930
SP;DOIS CORREGOS;9764;705;1630;2765;178;69;2261;17372
SP;DOLCINOPOLIS;1010;34;130;229;12;5;204;1624
SP;DOURADO;3573;205;584;713;65;32;735;5907
SP;DRACENA;19469;1152;3401;7142;145;255;5496;37060
SP;DUARTINA;4755;277;784;1212;84;19;688;7819
SP;DUMONT;3011;408;648;540;59;36;522;5224
SP;ECHAPORA;2034;180;421;363;33;28;212;3271
SP;ELDORADO;2511;301;449;1352;67;11;482;5173
SP;ELIAS FAUSTO;4849;387;790;1754;96;30;835;8741
SP;ELISIARIO;1044;55;154;272;11;4;161;1701
SP;EMBAUBA;794;77;143;115;29;0;121;1279
SP;EMBU;72265;2776;7342;22904;812;707;12449;119255
SP;EMBU-GUACU;24422;2313;3317;5515;381;243;3973;40164
SP;EMILIANOPOLIS;1013;54;173;375;15;3;106;1739
SP;ENGENHEIRO COELHO;5474;469;926;2296;203;47;1190;10605
SP;ESPIRITO SANTO DO PINHAL;17991;677;2566;5661;94;197;3287;30473
SP;ESPIRITO SANTO DO TURVO;1371;161;292;276;37;1;272;2410
SP;ESTIVA GERBI;4070;279;553;1407;32;20;930;7291
SP;ESTRELA D'OESTE;3466;254;656;1034;31;27;1106;6574
SP;ESTRELA DO NORTE;873;31;125;106;9;3;81;1228
SP;EUCLIDES DA CUNHA PAULISTA;2493;110;370;1107;58;4;414;4556
SP;FARTURA;5830;359;913;1439;49;66;855;9511
SP;FERNANDO PRESTES;2309;259;561;436;21;12;454;4052
SP;FERNANDOPOLIS;30764;1624;4813;12841;239;347;10580;61208
SP;FERNAO;485;34;102;151;14;1;92;879
SP;FERRAZ DE VASCONCELOS;50656;2070;4274;9212;537;267;5456;72472
SP;FLORA RICA;534;27;104;117;12;0;73;867
SP;FLOREAL;1208;66;213;299;8;5;190;1989
SP;FLORIDA PAULISTA;4191;355;573;663;130;16;714;6642
SP;FLORINEA;860;54;144;253;10;2;130;1453
SP;FRANCA;158851;3975;20374;60292;718;2931;23629;270770
SP;FRANCISCO MORATO;35670;600;2467;9446;238;120;3145;51686
SP;FRANCO DA ROCHA;40279;1015;3592;9596;209;252;3962;58905
SP;GABRIEL MONTEIRO;991;62;235;309;14;2;211;1824
SP;GALIA;2221;167;341;585;48;15;355;3732
SP;GARCA;16891;792;1882;6282;121;147;3393;29508
SP;GASTAO VIDIGAL;1372;73;188;432;64;4;186;2319
SP;GAVIAO PEIXOTO;1440;77;242;187;30;7;199;2182
SP;GENERAL SALGADO;4371;296;675;960;109;24;1134;7569
SP;GETULINA;3110;134;436;699;78;13;466;4936
SP;GLICERIO;1244;149;229;406;34;8;263;2333
SP;GUAICARA;3273;126;356;1181;36;7;1039;6018
SP;GUAIMBE;1639;127;191;309;37;4;190;2497
SP;GUAIRA;14530;1381;2820;4667;234;178;6064;29874
SP;GUAPIACU;6876;459;1189;2461;79;45;1506;12615
SP;GUAPIARA;3644;418;690;1775;66;19;492;7104
SP;GUARA;6173;255;801;1254;189;47;1361;10080
SP;GUARACAI;3096;298;697;1061;34;15;553;5754
SP;GUARACI;3262;223;446;805;114;20;833;5703
SP;GUARANI D'OESTE;681;36;105;203;8;2;109;1144
SP;GUARANTA;1976;103;266;569;49;8;338;3309
SP;GUARARAPES;11695;709;1633;4458;157;116;4130;22898
SP;GUARAREMA;11132;551;1482;3038;98;162;2412;18875
SP;GUARATINGUETA;45683;1441;5405;15881;248;830;6335;75823
SP;GUAREI;3489;327;608;1534;105;13;438;6514
SP;GUARIBA;12938;859;1550;3260;331;86;2750;21774
SP;GUARUJA;64702;2217;6309;39448;515;868;30460;144519
SP;GUARULHOS;469284;20801;43946;91139;4117;5417;70945;705649
SP;GUATAPARA;2203;198;296;440;64;17;393;3611
SP;GUZOLANDIA;1591;93;241;308;42;6;199;2480
SP;HERCULANDIA;2727;521;704;764;34;11;484;5245
SP;HOLAMBRA;5394;433;1270;1697;170;132;1232;10328
SP;HORTOLANDIA;83187;2945;8452;19002;783;404;8803;123576
SP;IACANGA;3929;285;672;1007;53;20;1079;7045
SP;IACRI;2098;166;341;479;22;12;318;3436
SP;IARAS;1323;66;189;370;34;5;200;2187
SP;IBATE;11649;648;1560;3008;291;48;2053;19257
SP;IBIRA;4240;182;624;930;55;26;887;6944
SP;IBIRAREMA;1928;253;390;693;33;10;468;3775
SP;IBITINGA;23090;976;3045;10141;236;220;4987;42695
SP;IBIUNA;28082;2407;5392;9455;132;335;4137;49940
SP;ICEM;2664;256;391;529;74;8;675;4597
SP;IEPE;2767;204;467;720;37;17;466;4678
SP;IGARACU DO TIETE;8240;366;819;2390;92;36;1365;13308
SP;IGARAPAVA;9959;476;1381;1740;137;71;1849;15613
SP;IGARATA;3778;162;544;1121;19;51;508;6183
SP;IGUAPE;5914;260;869;2244;123;56;1390;10856
SP;ILHA COMPRIDA;3073;205;471;1223;92;50;845;5959
SP;ILHA SOLTEIRA;10067;285;1294;3952;96;61;3561;19316
SP;ILHABELA;8797;420;1859;6949;71;647;2978;21721
SP;INDAIATUBA;115491;3640;14453;37280;477;2043;22441;195825
SP;INDIANA;1879;125;298;513;12;7;328;3162
SP;INDIAPORA;1722;77;261;405;19;7;279;2770
SP;INUBIA PAULISTA;1399;57;199;303;15;9;189;2171
SP;IPAUSSU;4221;210;468;937;64;21;1032;6953
SP;IPERO;6791;315;836;2097;58;24;961;11082
SP;IPEUNA;2525;189;467;602;45;30;494;4352
SP;IPIGUA;1078;67;236;416;13;4;221;2035
SP;IPORANGA;629;34;131;256;9;4;79;1142
SP;IPUA;4615;273;732;990;97;27;1246;7980
SP;IRACEMAPOLIS;9164;576;1383;2433;110;115;2556;16337
SP;IRAPUA;2447;137;417;458;91;14;458;4022
SP;IRAPURU;2128;113;360;426;30;5;307;3369
SP;ITABERA;4552;346;778;1731;82;47;994;8530
SP;ITAI;8243;594;1376;1638;216;92;1687;13846
SP;ITAJOBI;6704;608;1555;1796;67;64;1252;12046
SP;ITAJU;923;79;213;180;24;3;153;1575
SP;ITANHAEM;26737;1117;2809;10457;148;263;4991;46522
SP;ITAOCA;507;41;85;320;10;2;65;1030
SP;ITAPECERICA DA SERRA;48748;2432;5176;14380;817;478;7494;79525
SP;ITAPETININGA;55415;3026;7179;22543;530;469;13872;103034
SP;ITAPEVA;33306;2142;4887;13122;440;347;8406;62650
SP;ITAPEVI;64856;2146;5811;19679;212;394;8238;101336
SP;ITAPIRA;30035;1869;4476;14946;244;407;6393;58370
SP;ITAPIRAPUA PAULISTA;646;52;156;440;22;3;105;1424
SP;ITAPOLIS;18644;1362;3246;5490;247;127;3919;33035
SP;ITAPORANGA;4352;280;755;1388;88;48;845;7756
SP;ITAPUI;4037;416;517;1193;70;37;901;7171
SP;ITAPURA;1013;31;119;269;20;1;199;1652
SP;ITAQUAQUECETUBA;88049;3462;7686;19654;445;443;9877;129616
SP;ITARARE;14511;1004;1878;4985;252;113;2628;25371
SP;ITARIRI;2409;402;431;883;28;25;503;4681
SP;ITATIBA;52660;2504;6816;12768;417;760;8317;84242
SP;ITATINGA;5811;281;858;1286;129;41;1057;9463
SP;ITIRAPINA;5252;350;796;1257;68;46;1156;8925
SP;ITIRAPUA;1931;97;298;427;24;7;201;2985
SP;ITOBI;2392;179;377;1012;109;10;343;4422
SP;ITU;74310;3285;9115;25099;688;1206;14132;127835
SP;ITUPEVA;23305;1579;3661;5924;122;389;4763;39743
SP;ITUVERAVA;15285;675;2220;4655;146;193;4529;27703
SP;JABORANDI;1896;195;361;781;52;28;594;3907
SP;JABOTICABAL;30970;2218;4872;11217;223;460;8878;58838
SP;JACAREI;94082;2792;8535;22365;323;1073;12442;141612
SP;JACI;2369;258;511;803;16;19;490;4466
SP;JACUPIRANGA;4305;439;689;1908;398;48;1085;8872
SP;JAGUARIUNA;23908;1102;3119;8844;136;362;4501;41972
SP;JALES;21926;1224;3791;10927;100;260;8126;46354
SP;JAMBEIRO;1777;127;322;418;16;34;276;2970
SP;JANDIRA;37689;1252;3748;10381;188;389;5135;58782
SP;JARDINOPOLIS;14487;1123;2156;3893;162;144;3479;25444
SP;JARINU;12174;698;1869;3884;65;140;1584;20414
SP;JAU;59262;2568;7256;21561;553;688;14539;106427
SP;JERIQUARA;1109;75;174;199;22;9;186;1774
SP;JOANOPOLIS;5414;449;951;2267;25;67;877;10050
SP;JOAO RAMALHO;1226;38;195;311;36;4;153;1963
SP;JOSE BONIFACIO;14060;945;2596;6756;163;146;5017;29683
SP;JULIO MESQUITA;1207;47;135;194;32;3;156;1774
SP;JUMIRIM;1024;118;227;197;7;17;153;1743
SP;JUNDIAI;216754;7945;24018;45538;1228;4040;33689;333212
SP;JUNQUEIROPOLIS;7151;546;1141;2229;230;50;1776;13123
SP;JUQUIA;4292;468;639;1507;30;25;828;7789
SP;JUQUITIBA;10122;759;1330;2701;117;118;1547;16694
SP;LAGOINHA;1799;173;370;1232;27;19;217;3837
SP;LARANJAL PAULISTA;10828;840;1732;2657;258;140;2025;18480
SP;LAVINIA;1492;82;295;538;20;3;338;2768
SP;LAVRINHAS;1996;89;226;704;15;19;242;3291
SP;LEME;37249;2556;5475;16359;607;356;10714;73316
SP;LENCOIS PAULISTA;27493;1525;3569;8802;387;236;6469;48481
SP;LIMEIRA;133219;4988;17022;41450;714;1679;25310;224382
SP;LINDOIA;3123;216;473;1039;31;25;411;5318
SP;LINS;32058;1330;3361;12107;217;288;11680;61041
SP;LORENA;28511;1003;2896;10412;49;430;4479;47780
SP;LOURDES;641;23;109;236;17;1;91;1118
SP;LOUVEIRA;18716;1032;2584;6959;101;268;2882;32542
SP;LUCELIA;7295;396;936;2320;216;36;1852;13051
SP;LUCIANOPOLIS;811;59;174;133;24;4;95;1300
SP;LUIS ANTONIO;4343;291;611;755;241;58;851;7150
SP;LUIZIANIA;1311;79;212;415;41;5;171;2234
SP;LUPERCIO;1221;52;166;312;33;3;123;1910
SP;LUTECIA;898;56;179;183;16;6;117;1455
SP;MACATUBA;6339;449;798;1560;94;43;1355;10638
SP;MACAUBAL;3268;153;539;887;25;16;572;5460
SP;MACEDONIA;1218;50;246;383;14;2;231;2144
SP;MAGDA;1357;129;262;236;15;7;272;2278
SP;MAIRINQUE;19648;637;2247;5223;87;139;2170;30151
SP;MAIRIPORA;33087;2124;4516;8255;202;605;4745;53534
SP;MANDURI;3989;272;647;865;111;19;687;6590
SP;MARABA PAULISTA;989;46;189;332;21;2;130;1709
SP;MARACAI;4750;330;762;1777;59;15;1082;8775
SP;MARAPOAMA;1106;177;348;391;16;14;441;2493
SP;MARIAPOLIS;1074;51;184;278;34;4;134;1759
SP;MARILIA;99063;3513;11087;36176;610;1101;21209;172759
SP;MARINOPOLIS;706;76;135;203;14;3;156;1293
SP;MARTINOPOLIS;8530;514;1279;2124;147;67;1870;14531
SP;MATAO;37763;1670;5098;13967;448;400;8731;68077
SP;MAUA;160061;4214;11142;36988;1555;1048;18822;233830
SP;MENDONCA;1991;124;359;474;30;9;554;3541
SP;MERIDIANO;1538;182;275;435;22;11;891;3354
SP;MESOPOLIS;599;20;102;211;14;0;133;1079
SP;MIGUELOPOLIS;6760;276;939;1691;97;43;1876;11682
SP;MINEIROS DO TIETE;4398;252;536;838;57;18;895;6994
SP;MIRA ESTRELA;1104;50;242;234;31;1;183;1845
SP;MIRACATU;4762;773;766;2017;45;23;997;9383
SP;MIRANDOPOLIS;9302;529;1640;3794;226;62;3116;18669
SP;MIRANTE DO PARANAPANEMA;4839;327;849;1888;103;14;695;8715
SP;MIRASSOL;24419;1335;3655;9707;107;282;5979;45484
SP;MIRASSOLANDIA;1387;74;311;491;11;4;212;2490
SP;MOCOCA;25556;1287;3617;8789;369;254;5565;45437
SP;MOGI DAS CRUZES;168575;6677;16740;29281;1365;2517;25534;250689
SP;MOGI-GUACU;64632;2602;7813;27136;632;762;15114;118691
SP;MOGI-MIRIM;41262;2150;5898;15829;228;642;7698;73707
SP;MOMBUCA;1268;101;196;287;20;3;200;2075
SP;MONCOES;794;80;185;254;14;4;469;1800
SP;MONGAGUA;14292;563;1529;4515;114;127;2442;23582
SP;MONTE ALEGRE DO SUL;3245;253;618;1471;50;61;557;6255
SP;MONTE ALTO;19095;1564;3351;11020;117;202;6093;41442
SP;MONTE APRAZIVEL;9510;657;1706;2821;277;81;2063;17115
SP;MONTE AZUL PAULISTA;7556;565;1442;2160;183;138;2030;14074
SP;MONTE CASTELO;1459;95;216;403;11;8;233;2425
SP;MONTE MOR;21016;910;2557;5095;150;124;2581;32433
SP;MONTEIRO LOBATO;1676;171;328;548;16;30;292;3061
SP;MORRO AGUDO;8971;797;1665;2779;200;133;4067;18612
SP;MORUNGABA;6345;416;1004;1443;32;61;846;10147
SP;MOTUCA;1417;153;290;335;31;7;248;2481
SP;MURUTINGA DO SUL;1355;88;292;411;19;9;298;2472
SP;NANTES;757;25;132;110;18;4;100;1146
SP;NARANDIBA;1386;94;210;341;26;1;320;2378
SP;NATIVIDADE DA SERRA;1498;119;326;663;10;12;226;2854
SP;NAZARE PAULISTA;6734;780;1107;2706;77;51;1057;12512
SP;NEVES PAULISTA;3599;208;555;874;28;22;569;5855
SP;NHANDEARA;4372;204;822;1093;66;47;948;7552
SP;NIPOA;1724;119;303;501;37;4;346;3034
SP;NOVA ALIANCA;2350;176;392;565;19;7;342;3851
SP;NOVA CAMPINA;1388;100;194;695;24;7;214;2622
SP;NOVA CANAA PAULISTA;723;41;113;157;8;0;103;1145
SP;NOVA CASTILHO;434;23;96;89;6;1;57;706
SP;NOVA EUROPA;3444;191;562;570;156;16;802;5741
SP;NOVA GRANADA;7263;388;1082;2692;135;34;2012;13606
SP;NOVA GUATAPORANGA;809;45;105;248;15;1;116;1339
SP;NOVA INDEPENDENCIA;1216;84;177;253;12;1;418;2161
SP;NOVA LUZITANIA;1190;39;145;270;28;1;129;1802
SP;NOVA ODESSA;28129;986;3711;7535;130;251;4262;45004
SP;NOVAIS;1320;113;181;445;47;1;300;2407
SP;NOVO HORIZONTE;15613;1222;2381;6099;340;168;4437;30260
SP;NUPORANGA;2560;233;567;377;67;18;446;4268
SP;OCAUCU;1483;123;278;396;27;7;188;2502
SP;OLEO;875;44;145;166;10;3;121;1364
SP;OLIMPIA;22665;1024;3550;7832;234;256;5114;40675
SP;ONDA VERDE;1229;127;199;273;33;5;383;2249
SP;ORIENTE;2014;101;322;459;25;16;498;3435
SP;ORINDIUVA;2061;288;459;388;64;15;593;3868
SP;ORLANDIA;16858;1049;2623;6485;340;295;6817;34467
SP;OSASCO;288818;9865;26896;64355;2818;3186;42625;438563
SP;OSCAR BRESSANE;863;74;231;175;10;1;113;1467
SP;OSVALDO CRUZ;12592;496;1625;4507;125;109;4522;23976
SP;OURINHOS;40754;2296;5583;17356;647;489;12105;79230
SP;OURO VERDE;2376;123;354;742;66;12;402;4075
SP;OUROESTE;3661;205;570;887;37;31;951;6342
SP;PACAEMBU;4543;216;659;869;42;23;915;7267
SP;PALESTINA;4251;197;726;772;52;18;759;6775
SP;PALMARES PAULISTA;2826;98;345;791;116;8;489;4673
SP;PALMEIRA D'OESTE;4043;273;793;1022;40;22;1094;7287
SP;PALMITAL;8073;722;1573;2172;68;86;2495;15189
SP;PANORAMA;4622;347;723;2082;28;28;1610;9440
SP;PARAGUACU PAULISTA;16075;927;2028;5895;175;86;5235;30421
SP;PARAIBUNA;6403;277;979;2181;80;73;739;10732
SP;PARAISO;2414;214;486;375;109;7;597;4202
SP;PARANAPANEMA;6243;638;1254;1324;95;88;1234;10876
SP;PARANAPUA;1460;116;311;508;24;3;313;2735
SP;PARAPUA;3608;339;637;959;67;17;816;6443
SP;PARDINHO;2195;183;476;453;35;27;616;3985
SP;PARIQUERA-ACU;4925;450;722;2337;22;56;1259;9771
SP;PARISI;814;43;138;312;15;1;175;1498
SP;PATROCINIO PAULISTA;4744;327;760;1034;67;48;646;7626
SP;PAULICEIA;2571;348;413;1058;33;13;747;5183
SP;PAULINIA;48078;2312;5852;9938;341;825;12489;79835
SP;PAULISTANIA;552;30;121;137;14;3;112;969
SP;PAULO DE FARIA;2722;119;367;385;54;11;379;4037
SP;PEDERNEIRAS;16836;1209;2537;7418;242;129;4097;32468
SP;PEDRA BELA;2199;257;489;1040;17;21;219;4242
SP;PEDRANOPOLIS;996;53;179;333;17;2;221;1801
SP;PEDREGULHO;5930;335;917;1236;139;61;854;9472
SP;PEDREIRA;16740;836;2765;11215;76;219;4184;36035
SP;PEDRINHAS PAULISTA;1027;191;375;341;11;12;245;2202
SP;PEDRO DE TOLEDO;2122;188;274;710;22;21;405;3742
SP;PENAPOLIS;24543;1534;3774;12079;317;288;9502;52037
SP;PEREIRA BARRETO;9055;431;1214;3124;119;45;3140;17128
SP;PEREIRAS;2389;268;378;649;33;18;399;4134
SP;PERUIBE;21057;730;2411;7776;117;272;4349;36712
SP;PIACATU;1891;100;333;516;30;10;343;3223
SP;PIEDADE;19112;1689;3992;8360;121;173;3256;36703
SP;PILAR DO SUL;11765;1191;2400;4640;103;106;2230;22435
SP;PINDAMONHANGABA;59062;2044;5671;19860;211;611;8543;96002
SP;PINDORAMA;5502;323;755;1532;65;25;914;9116
SP;PINHALZINHO;5889;490;1093;1684;28;54;799;10037
SP;PIQUEROBI;1076;60;225;306;12;1;168;1848
SP;PIQUETE;4169;214;461;1155;16;29;479;6523
SP;PIRACAIA;10353;584;1570;4746;29;133;1608;19023
SP;PIRACICABA;190748;7939;24707;56576;1477;2986;32826;317259
SP;PIRAJU;12337;551;1757;3497;80;141;2170;20533
SP;PIRAJUI;7542;352;1076;2304;97;62;1384;12817
SP;PIRANGI;4046;447;965;1028;86;31;1274;7877
SP;PIRAPORA DO BOM JESUS;5302;373;598;1647;130;31;747;8828
SP;PIRAPOZINHO;9280;514;1187;3267;111;74;2204;16637
SP;PIRASSUNUNGA;33628;1153;3734;12456;245;333;7476;59025
SP;PIRATININGA;5437;303;905;1257;48;57;856;8863
SP;PITANGUEIRAS;10670;1018;1552;3902;345;129;3409;21025
SP;PLANALTO;1506;189;250;436;63;4;438;2886
SP;PLATINA;840;66;180;295;17;4;105;1507
SP;POA;38243;998;3274;6877;196;310;4913;54811
SP;POLONI;2094;191;392;511;59;23;367;3637
SP;POMPEIA;8695;318;1414;2487;62;66;1246;14288
SP;PONGAI;1561;67;244;234;21;6;205;2338
SP;PONTAL;11370;1093;1613;2813;577;62;3379;20907
SP;PONTALINDA;1079;43;139;374;37;0;186;1858
SP;PONTES GESTAL;961;73;179;184;27;3;245;1672
SP;POPULINA;1605;60;252;360;15;13;283;2588
SP;PORANGABA;3093;199;559;913;19;14;386;5183
SP;PORTO FELIZ;20243;1414;3147;6441;212;231;3213;34901
SP;PORTO FERREIRA;21544;1231;2888;11409;178;254;5611;43115
SP;POTIM;3945;92;388;1998;27;16;658;7124
SP;POTIRENDABA;7240;557;1355;1806;91;38;2034;13121
SP;PRACINHA;456;13;59;168;15;0;34;745
SP;PRADOPOLIS;5478;436;818;1157;252;40;2119;10300
SP;PRAIA GRANDE;82412;2350;7686;33413;375;1084;20779;148099
SP;PRATANIA;1806;136;264;372;87;7;911;3583
SP;PRESIDENTE ALVES;1292;56;198;330;52;11;188;2127
SP;PRESIDENTE BERNARDES;5013;279;909;1563;51;42;890;8747
SP;PRESIDENTE EPITACIO;14821;575;2021;6003;199;88;5297;29004
SP;PRESIDENTE PRUDENTE;99142;4210;13865;35813;873;1644;20513;176060
SP;PRESIDENTE VENCESLAU;14446;730;2356;5863;86;139;4755;28375
SP;PROMISSAO;13606;798;1720;4667;198;91;4428;25508
SP;QUADRA;704;77;177;412;20;10;132;1532
SP;QUATA;4871;250;614;1155;97;25;1172;8184
SP;QUEIROZ;888;30;111;204;16;3;87;1339
SP;QUELUZ;2483;130;265;797;15;15;362;4067
SP;QUINTANA;2119;223;364;410;29;12;343;3500
SP;RAFARD;3368;256;498;1016;31;20;1096;6285
SP;RANCHARIA;11323;681;1513;3761;101;83;2308;19770
SP;REDENCAO DA SERRA;1158;95;202;481;34;9;192;2171
SP;REGENTE FEIJO;7558;450;1165;1887;72;55;1648;12835
SP;REGINOPOLIS;2097;85;287;390;26;17;413;3315
SP;REGISTRO;18452;1346;2741;8447;352;177;4459;35974
SP;RESTINGA;1945;134;289;744;35;10;325;3482
SP;RIBEIRA;477;35;83;260;22;3;92;972
SP;RIBEIRAO BONITO;4204;319;693;1039;117;25;834;7231
SP;RIBEIRAO BRANCO;2830;288;470;1693;88;9;363;5741
SP;RIBEIRAO CORRENTE;1311;118;310;478;50;11;219;2497
SP;RIBEIRAO DO SUL;1531;158;308;522;17;10;272;2818
SP;RIBEIRAO DOS INDIOS;585;33;137;372;6;4;98;1235
SP;RIBEIRAO GRANDE;1683;82;282;1000;16;12;484;3559
SP;RIBEIRAO PIRES;48912;2786;4520;6737;471;615;6728;70769
SP;RIBEIRAO PRETO;303824;11629;38101;110217;2130;7103;71227;544231
SP;RIFAINA;1549;58;254;254;12;27;284;2438
SP;RINCAO;3622;272;439;701;52;14;591;5691
SP;RINOPOLIS;3409;223;545;964;60;20;1328;6549
SP;RIO CLARO;91215;3527;10728;40573;565;1353;26921;174882
SP;RIO DAS PEDRAS;12413;694;1656;3049;197;68;2757;20834
SP;RIO GRANDE DA SERRA;13888;488;947;2582;97;65;1763;19830
SP;RIOLANDIA;2539;100;419;552;66;12;508;4196
SP;RIVERSUL;1245;98;173;644;38;7;238;2443
SP;ROSANA;5558;196;698;1467;79;45;1697;9740
SP;ROSEIRA;3524;150;369;1167;19;32;480;5741
SP;RUBIACEA;845;32;109;205;13;5;132;1341
SP;RUBINEIA;1292;43;172;307;15;9;383;2221
SP;SABINO;1651;65;273;615;16;9;432;3061
SP;SAGRES;728;24;77;193;6;1;55;1084
SP;SALES;2111;105;344;421;42;11;422;3456
SP;SALES OLIVEIRA;4247;297;747;889;62;42;1014;7298
SP;SALESOPOLIS;6207;855;935;2248;115;64;974;11398
SP;SALMOURAO;1221;40;150;317;50;0;143;1921
SP;SALTINHO;3263;381;822;506;12;26;802;5812
SP;SALTO;49825;2555;5209;13558;179;459;6715;78500
SP;SALTO DE PIRAPORA;15362;795;1805;4472;109;84;2203;24830
SP;SALTO GRANDE;2456;169;365;749;34;15;546;4334
SP;SANDOVALINA;1241;85;207;284;22;6;225;2070
SP;SANTA ADELIA;6117;572;873;1507;80;43;1925;11117
SP;SANTA ALBERTINA;2240;133;428;709;26;11;714;4261
SP;SANTA BARBARA D'OESTE;88197;2589;9379;27919;415;729;15786;145014
SP;SANTA BRANCA;4772;147;562;1054;37;52;477;7101
SP;SANTA CLARA D'OESTE;785;35;126;210;11;2;197;1366
SP;SANTA CRUZ DA CONCEICAO;1633;157;408;387;17;7;279;2888
SP;SANTA CRUZ DA ESPERANCA;584;59;134;52;6;4;100;939
SP;SANTA CRUZ DAS PALMEIRAS;10538;638;1308;3013;271;95;2964;18827
SP;SANTA CRUZ DO RIO PARDO;17492;1613;3502;6441;130;231;5167;34576
SP;SANTA ERNESTINA;2009;74;327;453;84;7;298;3252
SP;SANTA FE DO SUL;14447;716;2074;4303;63;172;5568;27343
SP;SANTA GERTRUDES;9039;629;1134;3762;43;81;2225;16913
SP;SANTA ISABEL;17835;1308;2231;6037;118;177;2533;30239
SP;SANTA LUCIA;2773;122;292;712;53;5;347;4304
SP;SANTA MARIA DA SERRA;2048;245;395;312;35;7;748;3790
SP;SANTA MERCEDES;939;53;126;231;9;3;196;1557
SP;SANTA RITA D'OESTE;952;43;206;298;7;8;203;1717
SP;SANTA RITA DO PASSA QUATRO;11694;594;1626;3020;59;204;2234;19431
SP;SANTA ROSA DE VITERBO;10748;482;1243;2287;109;96;1728;16693
SP;SANTA SALETE;561;50;161;210;9;0;207;1198
SP;SANTANA DA PONTE PENSA;608;30;155;159;6;2;107;1067
SP;SANTANA DE PARNAIBA;52771;2016;6522;11451;231;3328;9977;86296
SP;SANTO ANASTACIO;7297;515;1169;3043;71;61;2018;14174
SP;SANTO ANDRE;378582;8877;29074;69346;1814;4983;48117;540793
SP;SANTO ANTONIO DA ALEGRIA;2233;135;426;293;34;7;274;3402
SP;SANTO ANTONIO DE POSSE;8608;913;1375;3039;178;112;1677;15902
SP;SANTO ANTONIO DO ARACANGUA;2231;196;421;592;92;10;599;4141
SP;SANTO ANTONIO DO JARDIM;2158;229;474;473;21;17;276;3648
SP;SANTO ANTONIO DO PINHAL;2563;188;541;1085;12;50;391;4830
SP;SANTO EXPEDITO;947;30;154;211;19;1;94;1456
SP;SANTOPOLIS DO AGUAPEI;1257;66;180;254;36;1;182;1976
SP;SANTOS;143372;5352;11919;50792;650;4745;60654;277484
SP;SAO BENTO DO SAPUCAI;3681;198;689;1323;13;79;461;6444
SP;SAO BERNARDO DO CAMPO;407796;11277;34520;75988;4240;6040;66782;606643
SP;SAO CAETANO DO SUL;105221;2700;9202;12001;542;2692;15958;148316
SP;SAO CARLOS;120308;4049;13657;32207;461;1470;17537;189689
SP;SAO FRANCISCO;1009;52;175;316;19;1;174;1746
SP;SAO JOAO DA BOA VISTA;40637;2170;5808;14283;115;732;9258;73003
SP;SAO JOAO DAS DUAS PONTES;897;29;126;159;5;1;126;1343
SP;SAO JOAO DE IRACEMA;594;29;92;200;12;1;102;1030
SP;SAO JOAO DO PAU D'ALHO;853;39;197;214;8;1;121;1433
SP;SAO JOAQUIM DA BARRA;17909;807;2364;7574;220;227;7089;36190
SP;SAO JOSE DA BELA VISTA;1879;84;287;458;53;5;253;3019
SP;SAO JOSE DO BARREIRO;917;48;177;333;5;18;112;1610
SP;SAO JOSE DO RIO PARDO;23380;1324;3828;6640;174;285;3314;38945
SP;SAO JOSE DO RIO PRETO;219968;8272;31121;87036;1695;4127;49903;402122
SP;SAO JOSE DOS CAMPOS;308290;7118;29514;58721;1852;5940;37295;448730
SP;SAO LOURENCO DA SERRA;5571;361;857;1314;32;82;633;8850
SP;SAO LUIZ DO PARAITINGA;3480;228;664;1512;27;54;447;6412
SP;SAO MANUEL;17174;793;1869;3871;244;101;3727;27779
SP;SAO MIGUEL ARCANJO;9950;795;1740;3385;97;65;1494;17526
SP;SAO PAULO;5868736;135850;518441;1011478;47508;150735;833538;8566286
SP;SAO PEDRO;15451;716;2220;4103;113;215;3369;26187
SP;SAO PEDRO DO TURVO;2109;198;463;734;53;7;309;3873
SP;SAO ROQUE;32135;1266;4415;7792;244;482;4274;50608
SP;SAO SEBASTIAO;19632;925;3058;8952;207;539;4940;38253
SP;SAO SEBASTIAO DA GRAMA;3968;276;623;800;53;38;533;6291
SP;SAO SIMAO;5767;427;805;974;59;77;896;9005
SP;SAO VICENTE;68433;2215;5120;42439;995;704;24978;144884
SP;SARAPUI;3066;190;521;1673;21;12;511;5994
SP;SARUTAIA;1223;68;134;241;37;3;141;1847
SP;SEBASTIANOPOLIS DO SUL;1465;275;281;409;17;5;720;3172
SP;SERRA AZUL;2882;208;372;407;130;5;359;4363
SP;SERRA NEGRA;12248;514;1803;4670;53;210;1997;21495
SP;SERRANA;13970;734;1846;3896;273;102;2947;23768
SP;SERTAOZINHO;46773;2848;7122;20085;708;666;15636;93838
SP;SETE BARRAS;2545;286;558;1736;34;13;501;5673
SP;SEVERINIA;5345;332;726;1003;280;25;1128;8839
SP;SILVEIRAS;1800;92;254;810;7;11;154;3128
SP;SOCORRO;15905;1025;3230;8715;67;204;2739;31885
SP;SOROCABA;314979;8246;32157;83027;1617;4235;41262;485523
SP;SUD MENNUCCI;2576;159;437;502;71;8;635;4388
SP;SUMARE;113644;3171;11417;27763;748;746;15697;173186
SP;SUZANAPOLIS;1190;90;236;269;22;11;366;2184
SP;SUZANO;100912;3705;9068;16304;962;956;12681;144588
SP;TABAPUA;4368;177;751;1255;68;17;1688;8324
SP;TABATINGA;6090;359;1130;1367;216;32;1059;10253
SP;TABOAO DA SERRA;84661;2657;8609;24450;545;962;13809;135693
SP;TACIBA;1866;98;374;562;27;16;262;3205
SP;TAGUAI;3445;210;593;578;33;28;500;5387
SP;TAIACU;1907;161;376;454;33;2;369;3302
SP;TAIUVA;2104;165;423;332;31;18;454;3527
SP;TAMBAU;9466;610;1234;2471;89;111;1355;15336
SP;TANABI;10439;549;1526;3192;138;67;2199;18110
SP;TAPIRAI;2229;216;342;596;14;16;302;3715
SP;TAPIRATIBA;4470;379;579;750;87;23;569;6857
SP;TAQUARAL;781;65;127;130;25;1;245;1374
SP;TAQUARITINGA;23242;1721;3552;6783;382;160;4618;40458
SP;TAQUARITUBA;8484;879;1702;2213;132;111;1855;15376
SP;TAQUARIVAI;1175;102;230;396;20;7;208;2138
SP;TARABAI;2134;122;255;653;34;3;305;3506
SP;TARUMA;4532;384;664;1088;189;29;1267;8153
SP;TATUI;43957;2677;5778;22004;702;418;11659;87195
SP;TAUBATE;132890;3307;12430;50843;552;1784;20177;221983
SP;TEJUPA;877;54;168;185;10;2;146;1442
SP;TEODORO SAMPAIO;6751;404;967;2650;317;43;1853;12985
SP;TERRA ROXA;2914;202;432;556;87;12;586;4789
SP;TIETE;16141;1302;2633;4899;245;208;3137;28565
SP;TIMBURI;874;29;111;137;5;3;102;1261
SP;TORRE DE PEDRA;859;50;144;219;9;3;96;1380
SP;TORRINHA;4286;477;897;712;55;23;1255;7705
SP;TRABIJU;570;50;88;80;9;1;72;870
SP;TREMEMBE;13513;524;1392;4257;23;224;2052;21985
SP;TRES FRONTEIRAS;2212;80;317;692;14;3;694;4012
SP;TUIUTI;1951;131;366;822;24;13;215;3522
SP;TUPA;28435;1704;4149;13050;284;261;8090;55973
SP;TUPI PAULISTA;5845;358;958;1826;31;55;1339;10412
SP;TURIUBA;687;33;122;210;15;2;107;1176
SP;TURMALINA;707;26;184;129;10;3;152;1211
SP;UBARANA;1708;146;290;415;45;5;462;3071
SP;UBATUBA;25486;875;3570;13923;95;524;5841;50314
SP;UBIRAJARA;1604;121;327;433;59;10;236;2790
SP;UCHOA;3796;188;601;1153;51;14;635;6438
SP;UNIAO PAULISTA;667;51;86;191;13;1;118;1127
SP;URANIA;3760;180;609;1070;37;15;1259;6930
SP;URU;524;16;67;103;9;0;81;800
SP;URUPES;5741;442;1061;1230;60;38;1766;10338
SP;VALENTIM GENTIL;4847;306;777;1724;47;19;1434;9154
SP;VALINHOS;65925;2246;8236;13220;2006;1314;9525;102472
SP;VALPARAISO;7459;489;1001;1649;172;40;1861;12671
SP;VARGEM;4060;383;647;1152;30;24;498;6794
SP;VARGEM GRANDE DO SUL;15343;1296;2577;5430;233;204;3387;28470
SP;VARGEM GRANDE PAULISTA;21282;966;2678;3822;80;342;2593;31763
SP;VARZEA PAULISTA;44265;1246;4386;13289;437;247;6302;70172
SP;VERA CRUZ;4049;180;454;1100;43;22;587;6435
SP;VINHEDO;40552;1549;5380;9030;167;1174;5689;63541
SP;VIRADOURO;6953;416;932;1610;111;17;2057;12096
SP;VISTA ALEGRE DO ALTO;2407;421;564;695;141;16;1027;5271
SP;VITORIA BRASIL;578;35;111;207;10;4;148;1093
SP;VOTORANTIM;45476;1303;4171;14322;249;314;6285;72120
SP;VOTUPORANGA;41802;2165;5915;20955;351;514;15452;87154
SP;ZACARIAS;919;70;175;301;28;3;158;1654
TO;ABREULANDIA;199;30;78;272;3;1;86;669
TO;AGUIARNOPOLIS;467;58;129;874;14;2;441;1985
TO;ALIANCA DO TOCANTINS;638;92;262;723;16;1;382;2114
TO;ALMAS;500;77;161;720;11;1;246;1716
TO;ALVORADA;1463;212;511;1204;20;18;1006;4434
TO;ANANAS;655;83;252;1420;36;6;540;2992
TO;ANGICO;150;39;80;310;10;5;123;717
TO;APARECIDA DO RIO NEGRO;424;64;140;572;6;4;272;1482
TO;ARAGOMINAS;185;54;111;461;17;1;201;1030
TO;ARAGUACEMA;291;44;110;532;12;3;193;1185
TO;ARAGUACU;1216;135;504;1381;14;10;804;4064
TO;ARAGUAINA;34798;3734;12513;35605;765;871;32708;120994
TO;ARAGUANA;278;89;61;442;19;2;210;1101
TO;ARAGUATINS;2228;312;883;5704;89;15;2482;11713
TO;ARAPOEMA;482;55;242;1342;16;2;441;2580
TO;ARRAIAS;807;53;321;709;13;2;220;2125
TO;AUGUSTINOPOLIS;1240;203;501;3407;44;15;1308;6718
TO;AURORA DO TOCANTINS;261;11;74;322;5;0;64;737
TO;AXIXA DO TOCANTINS;569;49;206;1796;13;4;433;3070
TO;BABACULANDIA;320;204;142;630;23;2;536;1857
TO;BANDEIRANTES DO TOCANTINS;249;32;89;352;4;3;133;862
TO;BARRA DO OURO;148;21;64;334;2;0;110;679
TO;BARROLANDIA;467;69;215;810;7;3;259;1830
TO;BERNARDO SAYAO;267;38;150;915;7;3;176;1556
TO;BOM JESUS DO TOCANTINS;214;12;76;509;4;0;172;987
TO;BRASILANDIA DO TOCANTINS;177;19;54;266;4;0;73;593
TO;BREJINHO DE NAZARE;414;62;142;564;24;4;253;1463
TO;BURITI DO TOCANTINS;278;51;138;1456;6;2;221;2152
TO;CACHOEIRINHA;130;9;33;201;1;0;84;458
TO;CAMPOS LINDOS;220;71;160;840;8;2;421;1722
TO;CARIRI DO TOCANTINS;504;66;183;475;23;3;356;1610
TO;CARMOLANDIA;151;179;60;309;93;2;346;1140
TO;CARRASCO BONITO;95;12;40;380;3;0;87;617
TO;CASEARA;322;37;129;455;8;3;184;1138
TO;CENTENARIO;74;9;53;226;3;0;55;420
TO;CHAPADA DA NATIVIDADE;230;31;78;316;10;0;67;732
TO;CHAPADA DE AREIA;48;8;25;142;2;0;24;249
TO;COLINAS DO TOCANTINS;4691;614;1822;6177;82;67;5053;18506
TO;COLMEIA;1106;134;441;2311;21;5;783;4801
TO;COMBINADO;489;33;133;800;12;2;244;1713
TO;CONCEICAO DO TOCANTINS;198;22;85;299;3;1;62;670
TO;COUTO DE MAGALHAES;279;36;89;549;14;3;216;1186
TO;CRISTALANDIA;850;111;329;874;9;3;471;2647
TO;CRIXAS DO TOCANTINS;156;22;54;132;4;0;61;429
TO;DARCINOPOLIS;339;102;131;441;17;2;306;1338
TO;DIANOPOLIS;2786;289;848;2110;85;33;1458;7609
TO;DIVINOPOLIS DO TOCANTINS;639;115;301;1025;7;1;373;2461
TO;DOIS IRMAOS DO TOCANTINS;382;48;203;877;17;1;224;1752
TO;DUERE;299;54;138;475;5;1;203;1175
TO;ESPERANTINA;194;25;84;901;15;1;175;1395
TO;FATIMA;433;60;119;565;12;2;295;1486
TO;FIGUEIROPOLIS;697;101;265;771;10;5;442;2291
TO;FILADELFIA;263;53;148;431;14;3;328;1240
TO;FORMOSO DO ARAGUAIA;2244;292;746;2774;41;13;1434;7544
TO;FORTALEZA DO TABOCAO;289;33;96;496;7;1;237;1159
TO;GOIANORTE;377;48;206;907;18;2;237;1795
TO;GOIATINS;313;58;220;922;12;0;292;1817
TO;GUARAI;3548;472;1415;4071;39;52;3163;12760
TO;GURUPI;20734;1754;5802;18062;249;315;16784;63700
TO;IPUEIRAS;138;12;46;212;2;0;49;459
TO;ITACAJA;367;60;217;1311;4;1;335;2295
TO;ITAGUATINS;233;31;80;498;13;0;137;992
TO;ITAPIRATINS;209;30;87;505;12;3;196;1042
TO;ITAPORA DO TOCANTINS;175;22;81;376;8;4;76;742
TO;JAU DO TOCANTINS;333;25;98;397;9;1;118;981
TO;JUARINA;137;9;61;332;7;1;72;619
TO;LAGOA DA CONFUSAO;1035;239;515;1316;31;23;838;3997
TO;LAGOA DO TOCANTINS;99;15;89;375;5;0;95;678
TO;LAJEADO;353;36;95;337;11;4;169;1005
TO;LAVANDEIRA;136;4;27;194;3;1;22;387
TO;LIZARDA;42;20;65;233;1;0;34;395
TO;LUZINOPOLIS;163;16;63;289;3;0;112;646
TO;MARIANOPOLIS DO TOCANTINS;352;53;138;478;11;1;182;1215
TO;MATEIROS;58;30;59;159;4;14;62;386
TO;MAURILANDIA DO TOCANTINS;129;12;66;340;7;0;66;620
TO;MIRACEMA DO TOCANTINS;2793;208;798;2865;45;19;1995;8723
TO;MIRANORTE;1628;294;869;2586;27;14;1157;6575
TO;MONTE DO CARMO;338;36;137;554;10;1;232;1308
TO;MONTE SANTO DO TOCANTINS;133;20;49;242;4;0;60;508
TO;MURICILANDIA;126;13;60;297;6;0;87;589
TO;NATIVIDADE;896;116;371;1137;9;6;517;3052
TO;NAZARE;260;23;89;502;6;1;178;1059
TO;NOVA OLINDA;721;118;313;1375;33;1;727;3288
TO;NOVA ROSALANDIA;409;30;100;356;5;2;217;1119
TO;NOVO ACORDO;205;36;89;465;10;2;156;963
TO;NOVO ALEGRE;161;11;34;146;4;1;44;401
TO;NOVO JARDIM;184;20;58;152;4;1;68;487
TO;OLIVEIRA DE FATIMA;121;14;35;127;5;0;43;345
TO;PALMAS;80775;4913;19097;51275;1958;2292;35977;196287
TO;PALMEIRANTE;147;25;96;343;9;0;156;776
TO;PALMEIRAS DO TOCANTINS;410;38;114;533;11;1;295;1402
TO;PALMEIROPOLIS;1090;131;345;1578;23;5;613;3785
TO;PARAISO DO TOCANTINS;9463;1284;3364;10274;136;123;8234;32878
TO;PARANA;402;46;163;624;3;2;190;1430
TO;PAU D'ARCO;215;28;93;506;8;1;212;1063
TO;PEDRO AFONSO;1745;257;668;2404;51;14;1574;6713
TO;PEIXE;822;97;264;1092;47;7;536;2865
TO;PEQUIZEIRO;407;45;173;759;14;3;160;1561
TO;PINDORAMA DO TOCANTINS;194;26;102;559;8;0;86;975
TO;PIRAQUE;121;12;32;205;7;0;72;449
TO;PIUM;433;63;219;728;17;2;260;1722
TO;PONTE ALTA DO BOM JESUS;303;26;87;382;4;2;100;904
TO;PONTE ALTA DO TOCANTINS;352;31;183;890;5;18;232;1711
TO;PORTO ALEGRE DO TOCANTINS;201;13;66;240;8;2;56;586
TO;PORTO NACIONAL;9224;873;2799;10367;266;141;8033;31703
TO;PRAIA NORTE;223;16;64;661;5;1;164;1134
TO;PRESIDENTE KENNEDY;304;27;68;391;3;0;170;963
TO;PUGMIL;243;26;69;261;3;1;119;722
TO;RECURSOLANDIA;66;15;69;467;3;0;34;654
TO;RIACHINHO;217;111;81;422;70;1;247;1149
TO;RIO DA CONCEICAO;170;11;47;91;3;0;30;352
TO;RIO DOS BOIS;170;14;64;275;6;0;81;610
TO;RIO SONO;177;30;101;571;7;2;128;1016
TO;SAMPAIO;180;48;49;422;5;0;139;843
TO;SANDOLANDIA;299;26;126;488;1;1;187;1128
TO;SANTA FE DO ARAGUAIA;363;75;172;833;22;1;257;1723
TO;SANTA MARIA DO TOCANTINS;160;20;105;330;8;2;107;732
TO;SANTA RITA DO TOCANTINS;123;15;55;141;5;0;67;406
TO;SANTA ROSA DO TOCANTINS;311;50;143;594;5;7;157;1267
TO;SANTA TEREZA DO TOCANTINS;165;24;68;351;4;0;82;694
TO;SANTA TEREZINHA DO TOCANTINS;144;15;48;372;5;1;88;673
TO;SAO BENTO DO TOCANTINS;226;29;89;558;14;2;170;1088
TO;SAO FELIX DO TOCANTINS;36;9;42;102;1;0;24;214
TO;SAO MIGUEL DO TOCANTINS;308;108;88;977;48;3;355;1887
TO;SAO SALVADOR DO TOCANTINS;182;24;61;270;4;2;81;624
TO;SAO SEBASTIAO DO TOCANTINS;95;17;34;375;2;0;62;585
TO;SAO VALERIO DA NATIVIDADE;303;60;152;461;9;2;169;1156
TO;SILVANOPOLIS;510;59;177;579;6;4;374;1709
TO;SITIO NOVO DO TOCANTINS;541;46;133;1395;16;3;290;2424
TO;SUCUPIRA;156;14;47;212;7;0;59;495
TO;TAGUATINGA;1383;203;384;1692;32;14;686;4394
TO;TAIPAS DO TOCANTINS;94;6;31;126;3;1;29;290
TO;TALISMA;195;28;64;166;7;0;99;559
TO;TOCANTINIA;350;28;110;553;10;4;211;1266
TO;TOCANTINOPOLIS;3575;1117;1316;8520;366;28;5534;20456
TO;TUPIRAMA;160;22;52;176;10;1;111;532
TO;TUPIRATINS;105;12;35;164;9;0;63;388
TO;WANDERLANDIA;615;64;193;722;14;3;497;2108
TO;XAMBIOA;863;150;347;2438;26;8;1079;4911
